datetime,season,weather,temp,humidity,windspeed,casual,registered,count
2011-01-01 00:00:00,3,2,6.66,76.62,9.57,5,128,133
2011-01-01 01:00:00,4,3,13.54,55.91,4.01,36,184,220
2011-01-01 02:00:00,1,3,29.58,20.97,33.61,34,97,131
2011-01-01 03:00:00,3,1,7.4,61.64,15.85,6,47,53
2011-01-01 04:00:00,3,4,30.66,98.71,11.47,14,199,213
2011-01-01 05:00:00,4,1,7.76,61.84,19.0,20,20,40
2011-01-01 06:00:00,1,4,30.03,34.59,29.65,37,158,195
2011-01-01 07:00:00,1,1,15.82,21.77,33.59,35,185,220
2011-01-01 08:00:00,3,3,23.37,48.38,32.26,22,174,196
2011-01-01 09:00:00,2,1,9.59,93.46,43.16,28,22,50
2011-01-01 10:00:00,3,4,6.99,99.72,10.94,12,90,102
2011-01-01 11:00:00,3,2,11.48,95.63,31.84,4,6,10
2011-01-01 12:00:00,3,4,8.84,78.35,5.06,46,127,173
2011-01-01 13:00:00,3,2,14.37,64.65,27.4,38,48,86
2011-01-01 14:00:00,4,3,20.43,67.25,29.2,38,98,136
2011-01-01 15:00:00,1,4,22.66,63.12,10.81,41,30,71
2011-01-01 16:00:00,4,1,28.7,76.56,19.58,44,124,168
2011-01-01 17:00:00,4,4,24.69,53.51,41.36,42,174,216
2011-01-01 18:00:00,4,2,23.26,73.54,7.42,0,92,92
2011-01-01 19:00:00,3,3,17.35,29.73,21.73,19,195,214
2011-01-01 20:00:00,2,1,19.21,41.26,46.64,42,34,76
2011-01-01 21:00:00,1,4,17.44,86.88,25.21,0,33,33
2011-01-01 22:00:00,2,2,30.26,92.3,36.26,34,185,219
2011-01-01 23:00:00,4,1,11.9,63.12,41.34,39,14,53
2011-01-02 00:00:00,4,3,5.17,22.53,10.19,44,77,121
2011-01-02 01:00:00,2,1,24.54,94.16,10.91,6,84,90
2011-01-02 02:00:00,2,3,11.07,76.17,37.93,34,70,104
2011-01-02 03:00:00,2,1,31.7,53.12,37.67,33,80,113
2011-01-02 04:00:00,4,4,30.77,67.87,3.01,49,169,218
2011-01-02 05:00:00,4,2,7.3,54.38,16.12,4,145,149
2011-01-02 06:00:00,1,4,8.19,57.23,19.93,28,37,65
2011-01-02 07:00:00,1,4,19.86,90.94,41.45,49,63,112
2011-01-02 08:00:00,4,3,23.28,32.89,21.09,47,28,75
2011-01-02 09:00:00,2,3,13.25,28.29,46.3,26,117,143
2011-01-02 10:00:00,2,3,26.5,20.22,49.83,6,114,120
2011-01-02 11:00:00,1,4,22.85,45.12,39.04,0,9,9
2011-01-02 12:00:00,4,1,14.74,31.79,33.32,8,16,24
2011-01-02 13:00:00,1,1,5.76,37.6,19.59,46,159,205
2011-01-02 14:00:00,1,4,27.5,20.9,3.35,0,188,188
2011-01-02 15:00:00,3,4,11.44,38.18,28.66,26,114,140
2011-01-02 16:00:00,3,2,30.03,46.62,18.09,16,83,99
2011-01-02 17:00:00,3,3,17.61,22.53,17.54,31,80,111
2011-01-02 18:00:00,2,3,22.31,68.63,34.39,40,173,213
2011-01-02 19:00:00,4,4,31.19,65.5,23.18,29,70,99
2011-01-02 20:00:00,4,4,30.91,27.76,37.6,14,114,128
2011-01-02 21:00:00,4,1,16.15,67.6,19.91,41,55,96
2011-01-02 22:00:00,4,4,11.27,99.89,7.54,27,60,87
2011-01-02 23:00:00,3,1,28.25,95.56,23.07,2,102,104
2011-01-03 00:00:00,2,4,17.99,20.21,47.55,27,43,70
2011-01-03 01:00:00,2,2,10.76,83.63,40.08,4,165,169
2011-01-03 02:00:00,3,2,32.13,48.29,10.29,1,103,104
2011-01-03 03:00:00,2,1,10.94,25.09,19.57,37,177,214
2011-01-03 04:00:00,3,3,5.77,43.68,46.39,15,73,88
2011-01-03 05:00:00,4,2,5.61,45.74,6.18,43,31,74
2011-01-03 06:00:00,3,1,23.67,61.86,12.7,16,120,136
2011-01-03 07:00:00,4,4,24.85,72.89,13.11,11,89,100
2011-01-03 08:00:00,4,4,14.33,79.92,28.55,25,52,77
2011-01-03 09:00:00,1,1,14.6,39.67,20.54,48,175,223
2011-01-03 10:00:00,3,3,15.18,45.74,3.99,6,0,6
2011-01-03 11:00:00,1,1,25.4,44.67,31.46,23,102,125
2011-01-03 12:00:00,3,1,6.74,49.02,4.95,15,117,132
2011-01-03 13:00:00,3,2,32.87,99.97,30.32,17,29,46
2011-01-03 14:00:00,1,1,11.68,82.24,25.35,7,8,15
2011-01-03 15:00:00,1,1,34.99,98.0,24.68,26,107,133
2011-01-03 16:00:00,3,4,10.15,75.45,3.37,25,32,57
2011-01-03 17:00:00,2,2,28.15,52.5,31.96,30,25,55
2011-01-03 18:00:00,4,4,11.7,51.18,21.57,17,41,58
2011-01-03 19:00:00,1,4,7.43,59.09,20.56,1,41,42
2011-01-03 20:00:00,4,3,31.25,53.35,29.82,40,95,135
2011-01-03 21:00:00,2,3,30.76,86.27,30.31,22,38,60
2011-01-03 22:00:00,2,2,17.11,57.2,0.75,47,60,107
2011-01-03 23:00:00,2,2,26.07,43.65,6.26,48,46,94
2011-01-04 00:00:00,1,3,21.71,81.99,11.83,41,169,210
2011-01-04 01:00:00,2,3,30.59,88.35,33.9,21,47,68
2011-01-04 02:00:00,1,3,14.45,53.63,28.84,32,179,211
2011-01-04 03:00:00,2,3,20.71,73.42,37.88,17,160,177
2011-01-04 04:00:00,4,3,19.56,24.7,37.03,14,154,168
2011-01-04 05:00:00,4,4,15.62,62.36,42.66,40,170,210
2011-01-04 06:00:00,3,2,31.74,23.6,18.84,2,156,158
2011-01-04 07:00:00,4,4,9.98,22.34,17.25,47,146,193
2011-01-04 08:00:00,3,4,9.49,69.03,41.55,22,127,149
2011-01-04 09:00:00,4,1,22.31,44.27,11.88,46,98,144
2011-01-04 10:00:00,1,4,24.72,79.4,23.06,1,110,111
2011-01-04 11:00:00,4,3,10.84,91.69,9.72,41,27,68
2011-01-04 12:00:00,3,3,16.72,31.15,45.69,3,9,12
2011-01-04 13:00:00,3,1,33.4,77.96,20.39,25,194,219
2011-01-04 14:00:00,2,1,12.4,61.16,10.62,18,105,123
2011-01-04 15:00:00,1,1,25.05,28.97,34.6,48,143,191
2011-01-04 16:00:00,4,1,27.2,72.13,12.23,9,99,108
2011-01-04 17:00:00,2,1,18.44,68.76,47.18,21,0,21
2011-01-04 18:00:00,4,4,33.13,61.25,18.38,5,117,122
2011-01-04 19:00:00,4,1,27.1,94.12,33.23,0,81,81
2011-01-04 20:00:00,2,4,18.74,61.69,17.26,42,131,173
2011-01-04 21:00:00,2,2,22.08,99.24,40.36,15,196,211
2011-01-04 22:00:00,2,1,25.78,60.74,44.85,6,131,137
2011-01-04 23:00:00,2,1,22.77,29.27,39.4,23,114,137
2011-01-05 00:00:00,2,4,31.36,57.64,42.42,34,147,181
2011-01-05 01:00:00,4,2,15.71,34.59,5.09,13,62,75
2011-01-05 02:00:00,2,4,14.0,67.77,46.2,3,34,37
2011-01-05 03:00:00,1,4,11.42,75.45,31.22,40,115,155
2011-01-05 04:00:00,3,1,6.13,57.47,43.46,14,44,58
2011-01-05 05:00:00,2,3,6.29,27.82,34.22,43,56,99
2011-01-05 06:00:00,2,3,31.1,57.49,10.09,47,120,167
2011-01-05 07:00:00,4,4,25.35,26.52,30.48,22,151,173
2011-01-05 08:00:00,2,1,24.82,74.57,4.55,18,19,37
2011-01-05 09:00:00,2,2,23.44,83.23,34.79,13,155,168
2011-01-05 10:00:00,2,3,30.48,96.99,20.45,26,165,191
2011-01-05 11:00:00,4,2,19.41,31.9,7.59,35,151,186
2011-01-05 12:00:00,2,3,31.11,62.59,48.96,37,23,60
2011-01-05 13:00:00,3,1,15.78,65.4,45.05,21,69,90
2011-01-05 14:00:00,4,4,32.8,93.8,44.68,10,101,111
2011-01-05 15:00:00,3,2,25.96,70.18,39.44,3,126,129
2011-01-05 16:00:00,4,2,12.72,31.64,34.6,31,117,148
2011-01-05 17:00:00,2,4,21.92,54.91,32.75,39,24,63
2011-01-05 18:00:00,3,2,20.99,72.38,5.3,40,80,120
2011-01-05 19:00:00,4,3,9.14,76.02,45.03,23,196,219
2011-01-05 20:00:00,1,4,22.74,89.05,44.06,33,16,49
2011-01-05 21:00:00,2,3,14.44,34.44,37.39,2,57,59
2011-01-05 22:00:00,4,3,6.57,96.12,46.37,37,147,184
2011-01-05 23:00:00,1,1,33.46,24.73,27.65,1,1,2
2011-01-06 00:00:00,4,3,24.24,98.7,22.38,22,82,104
2011-01-06 01:00:00,1,1,31.31,88.62,48.4,39,8,47
2011-01-06 02:00:00,2,2,25.28,72.82,23.21,19,190,209
2011-01-06 03:00:00,3,2,15.71,78.8,32.07,7,122,129
2011-01-06 04:00:00,1,1,20.38,25.82,18.65,34,103,137
2011-01-06 05:00:00,4,3,25.27,23.32,31.82,48,82,130
2011-01-06 06:00:00,2,4,33.81,28.14,36.0,42,108,150
2011-01-06 07:00:00,1,4,12.61,26.99,31.23,2,119,121
2011-01-06 08:00:00,4,1,31.25,63.79,25.73,31,195,226
2011-01-06 09:00:00,4,2,32.72,37.24,15.01,30,133,163
2011-01-06 10:00:00,4,2,25.11,88.82,32.19,43,10,53
2011-01-06 11:00:00,1,4,32.94,55.66,45.42,45,148,193
2011-01-06 12:00:00,1,1,16.94,75.64,0.35,30,105,135
2011-01-06 13:00:00,1,4,33.59,72.23,6.7,0,190,190
2011-01-06 14:00:00,3,3,26.08,45.59,5.99,11,127,138
2011-01-06 15:00:00,1,3,6.26,39.45,46.16,17,29,46
2011-01-06 16:00:00,1,1,32.21,47.4,33.14,23,81,104
2011-01-06 17:00:00,1,1,19.53,83.73,47.59,35,114,149
2011-01-06 18:00:00,3,3,18.81,66.9,29.14,28,148,176
2011-01-06 19:00:00,1,2,21.99,40.28,23.09,24,150,174
2011-01-06 20:00:00,4,1,9.48,85.43,39.62,22,60,82
2011-01-06 21:00:00,1,3,19.07,24.38,8.05,2,157,159
2011-01-06 22:00:00,4,3,29.93,75.93,19.07,29,173,202
2011-01-06 23:00:00,4,2,5.46,55.13,23.31,16,187,203
2011-01-07 00:00:00,4,2,13.19,78.5,14.92,44,17,61
2011-01-07 01:00:00,3,2,5.07,94.2,18.56,48,61,109
2011-01-07 02:00:00,3,2,17.47,80.0,3.91,29,172,201
2011-01-07 03:00:00,3,4,26.85,55.36,9.9,48,60,108
2011-01-07 04:00:00,1,2,28.96,32.08,16.77,18,58,76
2011-01-07 05:00:00,4,4,33.36,84.51,39.79,4,162,166
2011-01-07 06:00:00,3,1,23.26,56.86,9.12,39,109,148
2011-01-07 07:00:00,3,3,12.64,26.02,17.33,33,149,182
2011-01-07 08:00:00,1,4,32.72,77.52,3.25,8,113,121
2011-01-07 09:00:00,3,1,28.26,43.35,27.86,38,151,189
2011-01-07 10:00:00,1,1,22.23,23.91,30.56,47,50,97
2011-01-07 11:00:00,2,4,25.87,92.22,43.28,43,64,107
2011-01-07 12:00:00,3,1,32.73,58.65,40.96,25,142,167
2011-01-07 13:00:00,2,1,26.37,42.48,14.27,4,111,115
2011-01-07 14:00:00,1,4,16.05,77.31,6.85,23,155,178
2011-01-07 15:00:00,4,1,26.39,90.87,7.8,30,41,71
2011-01-07 16:00:00,3,2,6.21,20.02,48.45,23,147,170
2011-01-07 17:00:00,1,2,16.59,75.03,33.66,20,42,62
2011-01-07 18:00:00,4,3,17.19,81.36,2.13,21,196,217
2011-01-07 19:00:00,4,1,10.01,36.79,6.84,37,190,227
2011-01-07 20:00:00,2,3,5.69,59.17,24.29,21,170,191
2011-01-07 21:00:00,1,2,9.0,27.14,10.39,20,1,21
2011-01-07 22:00:00,4,2,24.64,79.74,40.18,29,150,179
2011-01-07 23:00:00,3,2,29.07,87.8,28.66,48,139,187
2011-01-08 00:00:00,3,1,34.65,28.65,30.63,46,173,219
2011-01-08 01:00:00,2,1,15.39,85.32,23.14,9,125,134
2011-01-08 02:00:00,4,2,22.98,81.73,12.8,2,160,162
2011-01-08 03:00:00,1,3,33.11,47.75,29.47,38,43,81
2011-01-08 04:00:00,3,3,10.01,75.22,35.85,28,152,180
2011-01-08 05:00:00,4,4,26.53,20.0,18.55,24,34,58
2011-01-08 06:00:00,4,2,27.65,94.54,25.25,1,162,163
2011-01-08 07:00:00,2,3,7.67,64.03,41.98,12,64,76
2011-01-08 08:00:00,3,2,30.84,69.63,7.43,26,170,196
2011-01-08 09:00:00,3,3,29.39,73.17,27.26,28,195,223
2011-01-08 10:00:00,1,4,6.0,64.91,17.42,13,189,202
2011-01-08 11:00:00,3,4,7.73,88.54,35.14,3,158,161
2011-01-08 12:00:00,1,2,6.47,68.78,0.94,7,155,162
2011-01-08 13:00:00,3,3,15.04,92.62,33.52,4,138,142
2011-01-08 14:00:00,2,1,20.28,66.59,5.14,43,31,74
2011-01-08 15:00:00,3,4,20.97,33.69,3.24,26,65,91
2011-01-08 16:00:00,1,2,13.03,93.09,36.23,23,59,82
2011-01-08 17:00:00,1,2,32.35,74.53,32.02,43,178,221
2011-01-08 18:00:00,2,3,16.05,75.94,44.75,42,186,228
2011-01-08 19:00:00,3,2,6.37,98.84,25.98,33,144,177
2011-01-08 20:00:00,3,4,14.01,26.02,26.5,27,114,141
2011-01-08 21:00:00,2,2,20.93,54.29,35.35,23,67,90
2011-01-08 22:00:00,3,2,17.25,39.13,16.17,4,165,169
2011-01-08 23:00:00,3,1,13.22,70.43,1.85,12,63,75
2011-01-09 00:00:00,1,1,8.94,84.54,11.5,17,130,147
2011-01-09 01:00:00,3,4,29.57,97.3,11.9,16,53,69
2011-01-09 02:00:00,3,3,34.88,56.37,16.78,29,75,104
2011-01-09 03:00:00,2,1,14.89,82.9,47.17,37,171,208
2011-01-09 04:00:00,2,3,16.45,93.36,40.24,18,126,144
2011-01-09 05:00:00,4,4,23.54,74.67,46.8,21,157,178
2011-01-09 06:00:00,1,1,26.55,39.42,49.93,48,109,157
2011-01-09 07:00:00,3,3,16.76,68.63,21.69,48,87,135
2011-01-09 08:00:00,3,1,32.15,97.6,11.35,17,112,129
2011-01-09 09:00:00,4,4,21.8,99.0,28.0,25,53,78
2011-01-09 10:00:00,3,4,18.51,71.39,44.06,14,47,61
2011-01-09 11:00:00,1,1,24.4,90.96,23.29,27,34,61
2011-01-09 12:00:00,4,3,33.58,36.03,25.27,29,67,96
2011-01-09 13:00:00,1,2,28.84,39.69,6.72,27,25,52
2011-01-09 14:00:00,4,2,6.2,96.23,21.02,19,71,90
2011-01-09 15:00:00,4,1,14.97,30.82,19.35,3,87,90
2011-01-09 16:00:00,2,3,19.12,35.29,17.58,3,106,109
2011-01-09 17:00:00,1,2,14.44,53.64,44.36,36,55,91
2011-01-09 18:00:00,3,4,26.01,67.17,2.97,14,68,82
2011-01-09 19:00:00,3,3,29.79,68.31,48.61,33,79,112
2011-01-09 20:00:00,1,2,26.94,43.36,0.41,10,191,201
2011-01-09 21:00:00,3,3,34.68,93.65,47.28,22,95,117
2011-01-09 22:00:00,3,1,13.18,93.21,27.4,34,156,190
2011-01-09 23:00:00,1,3,31.25,51.37,35.12,42,125,167
2011-01-10 00:00:00,4,2,28.0,54.74,9.36,34,104,138
2011-01-10 01:00:00,1,1,15.87,76.2,32.71,10,58,68
2011-01-10 02:00:00,4,3,27.02,73.04,44.1,1,24,25
2011-01-10 03:00:00,3,4,8.12,50.58,6.97,14,199,213
2011-01-10 04:00:00,3,2,28.68,53.14,6.35,39,26,65
2011-01-10 05:00:00,3,1,20.97,47.84,15.2,27,98,125
2011-01-10 06:00:00,2,3,13.77,38.83,8.09,30,21,51
2011-01-10 07:00:00,4,4,24.67,56.65,5.53,31,198,229
2011-01-10 08:00:00,2,2,24.25,74.91,33.92,33,46,79
2011-01-10 09:00:00,2,4,11.28,79.36,10.69,49,121,170
2011-01-10 10:00:00,1,3,5.91,82.31,33.35,21,54,75
2011-01-10 11:00:00,2,3,18.01,49.98,43.1,28,8,36
2011-01-10 12:00:00,1,1,22.09,81.17,32.6,7,53,60
2011-01-10 13:00:00,1,4,31.3,20.52,5.97,21,113,134
2011-01-10 14:00:00,2,1,32.85,58.16,28.68,11,63,74
2011-01-10 15:00:00,4,2,20.86,83.51,19.68,22,117,139
2011-01-10 16:00:00,4,1,27.61,70.4,17.17,37,108,145
2011-01-10 17:00:00,4,2,18.18,57.93,15.93,1,98,99
2011-01-10 18:00:00,4,3,27.38,71.57,46.47,11,166,177
2011-01-10 19:00:00,4,3,11.14,92.56,37.13,20,82,102
2011-01-10 20:00:00,2,4,16.13,65.31,6.69,11,7,18
2011-01-10 21:00:00,2,2,24.03,83.98,23.8,44,106,150
2011-01-10 22:00:00,3,3,5.54,98.46,15.91,30,154,184
2011-01-10 23:00:00,4,4,26.67,76.45,48.9,8,196,204
2011-01-11 00:00:00,2,4,30.07,65.87,48.9,14,111,125
2011-01-11 01:00:00,3,1,16.97,23.0,15.98,31,160,191
2011-01-11 02:00:00,4,4,18.44,49.96,17.61,42,137,179
2011-01-11 03:00:00,1,3,30.54,65.24,29.97,8,105,113
2011-01-11 04:00:00,3,1,28.27,83.78,23.97,23,143,166
2011-01-11 05:00:00,2,2,13.64,55.05,10.66,7,10,17
2011-01-11 06:00:00,1,2,14.72,96.8,33.02,27,18,45
2011-01-11 07:00:00,1,3,25.37,41.74,16.71,17,191,208
2011-01-11 08:00:00,1,3,21.9,79.57,32.69,42,51,93
2011-01-11 09:00:00,3,1,9.87,53.52,19.18,36,142,178
2011-01-11 10:00:00,2,1,14.3,58.88,35.01,35,41,76
2011-01-11 11:00:00,1,3,32.0,84.2,33.39,36,99,135
2011-01-11 12:00:00,4,3,25.65,43.7,25.44,31,95,126
2011-01-11 13:00:00,1,2,34.58,27.74,35.24,20,82,102
2011-01-11 14:00:00,1,2,28.01,61.62,23.05,38,78,116
2011-01-11 15:00:00,3,2,33.26,62.3,5.81,48,165,213
2011-01-11 16:00:00,3,3,11.49,83.77,9.11,28,127,155
2011-01-11 17:00:00,2,4,28.14,97.47,12.3,17,85,102
2011-01-11 18:00:00,4,3,5.61,24.42,3.16,22,48,70
2011-01-11 19:00:00,3,3,25.12,67.34,35.57,32,76,108
2011-01-11 20:00:00,1,2,19.08,74.5,18.37,47,83,130
2011-01-11 21:00:00,2,3,15.4,98.86,4.68,8,48,56
2011-01-11 22:00:00,1,1,30.87,95.41,41.0,43,78,121
2011-01-11 23:00:00,1,3,30.63,77.0,34.18,42,198,240
2011-01-12 00:00:00,3,3,5.67,61.74,22.61,37,182,219
2011-01-12 01:00:00,2,3,23.29,32.92,12.37,3,149,152
2011-01-12 02:00:00,4,3,16.03,50.73,7.59,15,170,185
2011-01-12 03:00:00,4,4,17.47,66.81,22.92,2,49,51
2011-01-12 04:00:00,3,3,29.96,78.02,44.26,7,83,90
2011-01-12 05:00:00,3,1,14.3,70.83,9.42,15,123,138
2011-01-12 06:00:00,2,1,33.29,77.13,28.43,1,18,19
2011-01-12 07:00:00,4,3,10.39,54.33,48.08,44,90,134
2011-01-12 08:00:00,4,2,24.88,78.21,31.86,18,71,89
2011-01-12 09:00:00,4,4,25.16,31.5,22.0,23,145,168
2011-01-12 10:00:00,1,3,12.57,33.01,35.82,15,9,24
2011-01-12 11:00:00,4,3,14.74,33.03,41.23,39,49,88
2011-01-12 12:00:00,1,3,30.04,91.27,29.53,1,48,49
2011-01-12 13:00:00,2,2,27.85,26.08,43.59,31,168,199
2011-01-12 14:00:00,1,2,14.87,84.12,25.73,0,98,98
2011-01-12 15:00:00,2,2,21.02,38.69,41.5,48,142,190
2011-01-12 16:00:00,4,4,6.85,57.47,47.6,17,119,136
2011-01-12 17:00:00,4,1,11.26,93.28,25.06,38,22,60
2011-01-12 18:00:00,2,4,19.57,66.87,30.25,31,75,106
2011-01-12 19:00:00,3,2,7.58,36.81,30.47,8,112,120
2011-01-12 20:00:00,2,1,30.3,42.73,39.07,2,26,28
2011-01-12 21:00:00,3,1,26.54,93.64,41.15,23,5,28
2011-01-12 22:00:00,1,2,33.31,54.17,1.36,10,23,33
2011-01-12 23:00:00,1,2,25.8,66.96,36.67,27,85,112
2011-01-13 00:00:00,1,4,33.21,56.79,39.19,15,136,151
2011-01-13 01:00:00,4,2,21.64,50.28,35.02,28,189,217
2011-01-13 02:00:00,1,1,23.01,37.86,35.68,40,66,106
2011-01-13 03:00:00,3,3,34.31,74.9,2.07,11,69,80
2011-01-13 04:00:00,1,2,24.26,77.46,22.1,45,77,122
2011-01-13 05:00:00,2,2,5.92,41.99,40.91,3,41,44
2011-01-13 06:00:00,2,4,26.71,83.12,46.7,25,59,84
2011-01-13 07:00:00,4,4,32.16,88.36,11.47,3,82,85
2011-01-13 08:00:00,2,2,28.87,93.65,28.96,10,175,185
2011-01-13 09:00:00,3,1,22.51,32.9,40.22,1,183,184
2011-01-13 10:00:00,1,1,25.14,44.31,37.62,30,86,116
2011-01-13 11:00:00,4,3,34.71,88.83,30.94,49,132,181
2011-01-13 12:00:00,1,2,7.72,35.88,0.93,2,107,109
2011-01-13 13:00:00,1,4,25.02,20.28,36.19,24,181,205
2011-01-13 14:00:00,3,1,13.5,89.67,38.66,33,165,198
2011-01-13 15:00:00,2,3,24.2,46.12,36.14,0,146,146
2011-01-13 16:00:00,2,2,23.23,53.16,38.29,4,196,200
2011-01-13 17:00:00,1,1,9.6,55.71,21.55,38,70,108
2011-01-13 18:00:00,4,2,11.2,87.86,49.69,30,23,53
2011-01-13 19:00:00,2,2,23.65,47.03,38.54,35,104,139
2011-01-13 20:00:00,4,1,8.85,91.38,28.93,2,79,81
2011-01-13 21:00:00,2,1,12.96,69.36,46.71,37,137,174
2011-01-13 22:00:00,4,1,30.06,62.18,45.41,11,148,159
2011-01-13 23:00:00,3,2,14.81,46.05,40.73,15,142,157
2011-01-14 00:00:00,4,2,19.64,39.5,28.18,7,63,70
2011-01-14 01:00:00,3,3,33.23,69.92,26.36,10,140,150
2011-01-14 02:00:00,3,4,11.81,55.75,16.44,44,70,114
2011-01-14 03:00:00,4,2,16.69,92.84,12.54,13,167,180
2011-01-14 04:00:00,3,4,23.19,59.33,25.62,26,135,161
2011-01-14 05:00:00,1,1,27.66,60.94,28.89,17,104,121
2011-01-14 06:00:00,3,2,32.05,53.34,12.23,7,165,172
2011-01-14 07:00:00,2,3,32.46,83.14,46.13,32,51,83
2011-01-14 08:00:00,4,3,28.3,53.99,27.86,3,1,4
2011-01-14 09:00:00,1,4,11.85,41.55,26.33,48,149,197
2011-01-14 10:00:00,4,1,5.74,88.96,21.78,29,118,147
2011-01-14 11:00:00,2,4,16.51,67.75,2.9,19,117,136
2011-01-14 12:00:00,2,1,9.25,67.32,44.12,29,3,32
2011-01-14 13:00:00,2,3,26.31,68.87,15.85,26,51,77
2011-01-14 14:00:00,3,4,24.83,77.51,32.12,24,110,134
2011-01-14 15:00:00,3,3,6.32,45.05,30.37,5,6,11
2011-01-14 16:00:00,4,3,30.1,22.71,29.22,4,0,4
2011-01-14 17:00:00,4,1,12.46,84.85,26.29,13,82,95
2011-01-14 18:00:00,1,4,17.97,30.31,9.07,13,185,198
2011-01-14 19:00:00,1,4,25.04,77.75,14.03,33,189,222
2011-01-14 20:00:00,4,3,17.88,26.59,26.21,40,93,133
2011-01-14 21:00:00,3,3,18.24,50.02,39.47,24,113,137
2011-01-14 22:00:00,2,1,6.97,25.04,21.6,38,193,231
2011-01-14 23:00:00,4,2,17.04,61.78,10.2,17,54,71
2011-01-15 00:00:00,1,2,27.95,72.25,4.4,19,116,135
2011-01-15 01:00:00,3,3,32.46,33.71,33.15,42,12,54
2011-01-15 02:00:00,4,2,17.4,49.73,21.17,7,27,34
2011-01-15 03:00:00,4,2,17.71,94.42,6.27,25,13,38
2011-01-15 04:00:00,3,2,26.08,55.39,33.72,20,130,150
2011-01-15 05:00:00,4,2,33.28,84.2,10.38,26,15,41
2011-01-15 06:00:00,3,3,13.01,94.17,25.45,31,88,119
2011-01-15 07:00:00,2,2,18.2,97.95,15.31,41,173,214
2011-01-15 08:00:00,3,2,28.88,91.87,46.58,49,110,159
2011-01-15 09:00:00,3,1,23.29,45.39,11.41,16,120,136
2011-01-15 10:00:00,3,3,8.32,97.01,21.0,48,130,178
2011-01-15 11:00:00,4,4,23.83,84.99,47.97,0,97,97
2011-01-15 12:00:00,4,4,10.6,86.97,15.94,26,130,156
2011-01-15 13:00:00,3,1,20.31,21.21,32.23,35,168,203
2011-01-15 14:00:00,4,1,20.87,96.34,15.84,10,156,166
2011-01-15 15:00:00,1,3,31.29,82.25,5.53,40,167,207
2011-01-15 16:00:00,1,4,18.87,81.44,31.38,40,18,58
2011-01-15 17:00:00,4,2,13.38,26.52,45.8,34,147,181
2011-01-15 18:00:00,4,1,11.93,38.61,22.63,37,20,57
2011-01-15 19:00:00,3,4,31.23,96.98,31.31,37,147,184
2011-01-15 20:00:00,2,3,10.13,60.05,30.44,41,91,132
2011-01-15 21:00:00,4,2,17.78,51.83,20.75,41,46,87
2011-01-15 22:00:00,1,3,10.62,87.2,30.74,48,90,138
2011-01-15 23:00:00,3,1,28.2,26.99,12.97,46,43,89
2011-01-16 00:00:00,4,4,19.23,53.36,18.9,35,113,148
2011-01-16 01:00:00,1,4,15.53,50.06,22.12,9,88,97
2011-01-16 02:00:00,1,4,15.83,47.99,43.2,39,1,40
2011-01-16 03:00:00,2,4,30.57,44.62,17.42,0,170,170
2011-01-16 04:00:00,3,2,21.61,36.81,31.76,21,184,205
2011-01-16 05:00:00,3,2,26.54,33.83,10.67,16,87,103
2011-01-16 06:00:00,2,3,31.91,71.23,12.63,11,146,157
2011-01-16 07:00:00,2,2,32.05,93.55,32.42,43,89,132
2011-01-16 08:00:00,3,1,14.86,60.71,38.12,12,191,203
2011-01-16 09:00:00,3,1,33.57,43.84,23.11,24,173,197
2011-01-16 10:00:00,4,4,5.75,32.73,16.75,25,168,193
2011-01-16 11:00:00,4,1,16.31,86.41,45.51,45,66,111
2011-01-16 12:00:00,2,3,31.87,97.72,6.79,39,90,129
2011-01-16 13:00:00,4,2,13.24,47.93,36.04,45,13,58
2011-01-16 14:00:00,1,2,13.19,43.28,34.51,38,147,185
2011-01-16 15:00:00,4,2,14.08,68.12,34.51,48,34,82
2011-01-16 16:00:00,4,1,23.37,82.03,46.77,42,152,194
2011-01-16 17:00:00,1,2,18.15,56.43,36.41,32,127,159
2011-01-16 18:00:00,2,4,26.8,70.41,15.08,7,131,138
2011-01-16 19:00:00,1,4,31.85,77.32,17.67,12,56,68
2011-01-16 20:00:00,4,4,25.23,96.85,19.56,25,1,26
2011-01-16 21:00:00,2,1,11.13,33.2,1.54,16,65,81
2011-01-16 22:00:00,4,2,32.98,99.79,45.68,23,88,111
2011-01-16 23:00:00,1,1,12.93,51.37,3.68,23,110,133
2011-01-17 00:00:00,1,2,9.5,77.86,34.99,11,86,97
2011-01-17 01:00:00,4,3,7.7,65.79,36.51,30,148,178
2011-01-17 02:00:00,3,3,21.9,58.93,42.19,15,88,103
2011-01-17 03:00:00,3,1,8.41,75.85,27.67,41,90,131
2011-01-17 04:00:00,1,4,9.16,51.66,36.26,15,51,66
2011-01-17 05:00:00,1,1,14.0,30.09,15.14,29,117,146
2011-01-17 06:00:00,3,4,13.45,59.11,37.28,27,142,169
2011-01-17 07:00:00,3,2,23.13,61.75,17.17,2,173,175
2011-01-17 08:00:00,4,4,29.5,36.15,45.14,32,114,146
2011-01-17 09:00:00,4,4,27.84,94.85,8.17,23,30,53
2011-01-17 10:00:00,3,2,12.87,38.2,15.79,29,61,90
2011-01-17 11:00:00,4,3,12.36,52.74,24.94,39,33,72
2011-01-17 12:00:00,4,2,33.97,32.39,38.79,47,35,82
2011-01-17 13:00:00,2,1,5.25,62.86,37.44,27,120,147
2011-01-17 14:00:00,4,1,31.39,44.61,10.54,46,103,149
2011-01-17 15:00:00,1,1,10.99,59.14,7.21,38,43,81
2011-01-17 16:00:00,4,1,33.42,37.97,15.2,1,190,191
2011-01-17 17:00:00,4,1,15.27,24.3,24.19,12,76,88
2011-01-17 18:00:00,3,3,18.21,82.34,26.95,36,17,53
2011-01-17 19:00:00,1,3,26.21,71.29,21.46,9,44,53
2011-01-17 20:00:00,4,4,22.63,47.26,33.15,39,107,146
2011-01-17 21:00:00,4,1,14.54,23.8,21.38,12,166,178
2011-01-17 22:00:00,2,2,21.61,89.25,47.32,18,25,43
2011-01-17 23:00:00,4,1,26.92,33.58,13.05,5,111,116
2011-01-18 00:00:00,4,3,6.27,94.46,31.37,17,100,117
2011-01-18 01:00:00,2,1,5.34,58.29,30.57,39,74,113
2011-01-18 02:00:00,3,3,18.74,47.23,14.08,8,95,103
2011-01-18 03:00:00,4,4,8.96,79.34,20.58,16,23,39
2011-01-18 04:00:00,2,4,24.93,90.15,18.27,3,116,119
2011-01-18 05:00:00,1,4,11.42,49.66,8.62,49,185,234
2011-01-18 06:00:00,3,3,17.99,52.59,23.86,5,104,109
2011-01-18 07:00:00,1,1,10.93,54.65,19.33,10,177,187
2011-01-18 08:00:00,1,1,21.45,93.79,8.92,41,199,240
2011-01-18 09:00:00,2,2,8.48,75.41,22.49,25,38,63
2011-01-18 10:00:00,4,3,5.69,39.81,21.09,10,199,209
2011-01-18 11:00:00,2,2,6.53,34.8,6.57,7,110,117
2011-01-18 12:00:00,2,4,33.63,38.43,6.56,2,158,160
2011-01-18 13:00:00,2,1,9.27,41.09,32.38,1,82,83
2011-01-18 14:00:00,2,3,26.25,38.41,35.33,17,163,180
2011-01-18 15:00:00,3,2,7.04,72.68,47.06,1,166,167
2011-01-18 16:00:00,4,2,8.24,29.27,4.35,25,20,45
2011-01-18 17:00:00,1,2,20.27,50.99,5.89,11,22,33
2011-01-18 18:00:00,1,1,18.95,70.0,2.59,36,53,89
2011-01-18 19:00:00,4,1,33.55,43.27,26.61,25,163,188
2011-01-18 20:00:00,1,1,33.35,25.22,31.14,35,142,177
2011-01-18 21:00:00,4,3,28.39,26.55,20.18,15,129,144
2011-01-18 22:00:00,1,1,23.06,30.08,39.9,13,75,88
2011-01-18 23:00:00,2,3,18.65,86.87,34.33,1,69,70
2011-01-19 00:00:00,1,2,15.69,72.63,49.29,20,165,185
2011-01-19 01:00:00,4,2,33.41,25.16,6.89,6,64,70
2011-01-19 02:00:00,4,4,23.09,51.29,2.92,10,49,59
2011-01-19 03:00:00,4,1,22.37,42.29,13.74,43,116,159
2011-01-19 04:00:00,4,2,11.96,66.24,0.95,28,86,114
2011-01-19 05:00:00,4,1,6.4,61.82,46.63,36,0,36
2011-01-19 06:00:00,3,3,33.36,58.49,15.2,47,20,67
2011-01-19 07:00:00,3,2,14.41,45.16,27.62,38,56,94
2011-01-19 08:00:00,1,1,18.28,31.02,15.9,27,146,173
2011-01-19 09:00:00,4,2,8.44,79.39,12.29,39,28,67
2011-01-19 10:00:00,1,2,30.11,90.39,7.62,3,177,180
2011-01-19 11:00:00,4,1,5.83,95.53,16.02,3,33,36
2011-01-19 12:00:00,4,2,30.02,24.69,30.77,26,80,106
2011-01-19 13:00:00,3,2,9.21,79.19,48.58,5,53,58
2011-01-19 14:00:00,3,2,31.6,78.12,27.9,33,31,64
2011-01-19 15:00:00,2,2,26.89,95.77,26.64,40,131,171
2011-01-19 16:00:00,3,3,9.94,40.23,1.76,39,29,68
2011-01-19 17:00:00,2,2,21.97,79.37,42.0,17,94,111
2011-01-19 18:00:00,2,4,14.38,24.37,2.24,43,145,188
2011-01-19 19:00:00,2,2,10.35,70.5,45.31,47,68,115
2011-01-19 20:00:00,2,1,30.78,48.07,26.93,29,28,57
2011-01-19 21:00:00,2,4,17.11,81.51,8.42,32,139,171
2011-01-19 22:00:00,1,3,16.96,89.06,22.59,19,14,33
2011-01-19 23:00:00,3,4,10.1,49.19,49.75,35,78,113
2011-01-20 00:00:00,2,4,16.49,62.05,15.25,45,52,97
2011-01-20 01:00:00,4,4,31.15,29.39,13.47,49,162,211
2011-01-20 02:00:00,3,1,15.89,53.35,5.9,4,179,183
2011-01-20 03:00:00,3,1,33.55,48.86,29.86,34,180,214
2011-01-20 04:00:00,2,1,33.39,34.65,4.46,18,141,159
2011-01-20 05:00:00,1,3,9.35,91.56,38.3,11,102,113
2011-01-20 06:00:00,2,1,10.32,31.85,45.96,25,145,170
2011-01-20 07:00:00,1,1,30.88,70.86,46.59,18,165,183
2011-01-20 08:00:00,4,4,16.78,91.21,5.4,10,85,95
2011-01-20 09:00:00,3,1,5.13,92.96,27.91,19,165,184
2011-01-20 10:00:00,4,2,13.22,83.46,4.86,8,54,62
2011-01-20 11:00:00,1,1,22.93,34.09,28.6,19,138,157
2011-01-20 12:00:00,1,3,28.98,85.39,40.75,26,66,92
2011-01-20 13:00:00,4,3,9.0,42.13,26.89,4,52,56
2011-01-20 14:00:00,1,2,8.32,93.79,43.6,9,171,180
2011-01-20 15:00:00,4,3,32.66,76.73,40.08,8,152,160
2011-01-20 16:00:00,3,3,27.53,82.82,13.83,24,189,213
2011-01-20 17:00:00,4,4,22.69,26.8,31.51,12,141,153
2011-01-20 18:00:00,3,2,28.08,66.62,0.37,31,46,77
2011-01-20 19:00:00,4,4,17.87,85.69,19.8,7,94,101
2011-01-20 20:00:00,1,4,27.75,88.93,11.9,44,88,132
2011-01-20 21:00:00,4,1,16.15,22.29,46.86,26,182,208
2011-01-20 22:00:00,1,2,12.32,95.13,20.27,21,139,160
2011-01-20 23:00:00,4,1,26.87,23.47,32.7,27,6,33
2011-01-21 00:00:00,4,1,17.59,69.16,36.6,17,176,193
2011-01-21 01:00:00,2,4,34.44,75.47,38.66,22,141,163
2011-01-21 02:00:00,1,3,15.48,28.59,36.79,40,156,196
2011-01-21 03:00:00,2,2,32.65,23.84,14.46,30,174,204
2011-01-21 04:00:00,1,3,32.99,82.79,34.3,40,141,181
2011-01-21 05:00:00,2,4,12.26,50.77,27.45,33,178,211
2011-01-21 06:00:00,3,4,28.95,28.57,29.87,6,141,147
2011-01-21 07:00:00,4,4,17.99,81.01,0.04,4,86,90
2011-01-21 08:00:00,1,4,32.53,87.93,12.91,20,135,155
2011-01-21 09:00:00,1,4,18.5,66.99,46.53,5,76,81
2011-01-21 10:00:00,4,4,27.33,32.9,14.5,44,99,143
2011-01-21 11:00:00,1,3,19.01,21.22,21.9,49,107,156
2011-01-21 12:00:00,1,1,11.83,76.06,9.33,34,64,98
2011-01-21 13:00:00,2,3,10.98,64.01,6.93,41,36,77
2011-01-21 14:00:00,1,2,17.76,72.06,10.43,22,195,217
2011-01-21 15:00:00,3,3,27.66,85.05,27.68,2,15,17
2011-01-21 16:00:00,3,4,23.15,54.74,45.95,32,147,179
2011-01-21 17:00:00,4,3,25.66,29.96,16.31,37,194,231
2011-01-21 18:00:00,1,1,13.47,95.2,16.17,22,111,133
2011-01-21 19:00:00,4,2,19.44,63.62,28.21,15,198,213
2011-01-21 20:00:00,3,3,6.33,69.22,17.84,24,31,55
2011-01-21 21:00:00,1,1,29.53,94.67,45.52,48,196,244
2011-01-21 22:00:00,1,3,34.7,94.53,18.89,15,84,99
2011-01-21 23:00:00,4,2,17.21,65.77,24.52,24,157,181
2011-01-22 00:00:00,3,3,5.33,43.81,26.67,41,147,188
2011-01-22 01:00:00,1,4,10.09,99.77,39.1,6,185,191
2011-01-22 02:00:00,4,3,24.58,74.47,28.2,7,28,35
2011-01-22 03:00:00,3,1,23.36,52.67,11.96,2,151,153
2011-01-22 04:00:00,4,3,28.64,64.79,6.2,4,128,132
2011-01-22 05:00:00,2,1,12.62,53.27,46.89,18,26,44
2011-01-22 06:00:00,1,2,27.91,91.06,40.08,6,20,26
2011-01-22 07:00:00,2,3,25.64,58.6,1.15,49,144,193
2011-01-22 08:00:00,3,2,14.68,85.88,41.08,21,91,112
2011-01-22 09:00:00,2,2,21.36,87.21,29.53,25,159,184
2011-01-22 10:00:00,2,3,9.42,85.95,25.94,49,171,220
2011-01-22 11:00:00,3,1,18.58,77.78,0.61,24,113,137
2011-01-22 12:00:00,4,2,31.44,88.39,39.04,5,97,102
2011-01-22 13:00:00,2,2,17.64,50.98,9.9,4,21,25
2011-01-22 14:00:00,4,3,30.19,29.17,36.4,37,41,78
2011-01-22 15:00:00,2,3,22.71,87.4,0.79,37,120,157
2011-01-22 16:00:00,4,3,10.76,59.85,39.82,21,189,210
2011-01-22 17:00:00,3,3,22.43,30.19,1.15,30,47,77
2011-01-22 18:00:00,2,3,20.18,29.23,11.79,21,135,156
2011-01-22 19:00:00,3,4,16.96,32.74,13.41,10,129,139
2011-01-22 20:00:00,2,3,8.59,80.08,7.88,31,132,163
2011-01-22 21:00:00,3,1,17.5,76.87,24.05,16,27,43
2011-01-22 22:00:00,3,2,7.18,36.31,14.18,40,131,171
2011-01-22 23:00:00,2,1,7.96,87.75,49.66,21,52,73
2011-01-23 00:00:00,2,1,17.48,42.5,29.0,15,99,114
2011-01-23 01:00:00,2,4,14.16,83.44,28.32,41,128,169
2011-01-23 02:00:00,1,3,32.77,59.1,11.04,14,78,92
2011-01-23 03:00:00,4,2,16.27,78.52,20.43,7,133,140
2011-01-23 04:00:00,1,1,27.74,50.51,6.2,45,87,132
2011-01-23 05:00:00,1,3,20.91,47.77,38.13,47,182,229
2011-01-23 06:00:00,3,3,26.12,87.31,16.56,2,51,53
2011-01-23 07:00:00,2,4,12.8,22.82,37.6,12,76,88
2011-01-23 08:00:00,4,4,33.26,97.98,18.58,29,23,52
2011-01-23 09:00:00,3,4,20.9,71.85,49.44,27,189,216
2011-01-23 10:00:00,1,2,29.94,54.6,8.56,8,183,191
2011-01-23 11:00:00,2,1,15.95,70.24,0.08,11,92,103
2011-01-23 12:00:00,3,4,8.01,29.82,29.74,24,151,175
2011-01-23 13:00:00,2,4,25.21,61.12,47.65,36,107,143
2011-01-23 14:00:00,3,4,5.23,98.81,32.35,20,19,39
2011-01-23 15:00:00,2,1,19.26,38.82,4.29,38,33,71
2011-01-23 16:00:00,1,1,10.78,77.78,27.02,38,14,52
2011-01-23 17:00:00,4,4,23.82,54.8,45.47,18,50,68
2011-01-23 18:00:00,1,4,34.38,72.2,0.33,7,126,133
2011-01-23 19:00:00,4,3,18.93,36.39,8.35,37,3,40
2011-01-23 20:00:00,2,4,29.52,57.64,40.73,2,52,54
2011-01-23 21:00:00,3,2,20.23,98.41,44.7,21,141,162
2011-01-23 22:00:00,1,2,19.88,35.62,35.36,0,192,192
2011-01-23 23:00:00,4,4,32.91,70.92,49.58,37,160,197
2011-01-24 00:00:00,1,1,31.7,66.05,4.51,18,123,141
2011-01-24 01:00:00,4,3,28.57,65.2,27.28,20,49,69
2011-01-24 02:00:00,1,1,13.89,69.21,34.25,12,62,74
2011-01-24 03:00:00,4,4,21.35,60.18,35.13,26,49,75
2011-01-24 04:00:00,4,2,11.72,21.35,39.67,16,92,108
2011-01-24 05:00:00,2,3,18.32,92.01,45.88,49,73,122
2011-01-24 06:00:00,4,1,19.53,86.16,18.08,19,163,182
2011-01-24 07:00:00,2,1,29.95,33.93,2.15,29,85,114
2011-01-24 08:00:00,4,4,31.88,53.06,18.12,37,96,133
2011-01-24 09:00:00,3,3,17.44,81.64,33.58,10,198,208
2011-01-24 10:00:00,3,2,5.53,98.4,10.67,26,99,125
2011-01-24 11:00:00,3,4,30.85,96.09,40.5,37,177,214
2011-01-24 12:00:00,4,3,10.23,91.95,10.99,27,168,195
2011-01-24 13:00:00,2,1,23.66,32.67,0.5,25,97,122
2011-01-24 14:00:00,2,4,5.75,93.16,25.4,38,197,235
2011-01-24 15:00:00,4,1,16.99,90.28,36.32,32,154,186
2011-01-24 16:00:00,3,1,34.58,50.16,17.48,31,29,60
2011-01-24 17:00:00,3,4,8.02,51.56,37.44,24,159,183
2011-01-24 18:00:00,2,4,17.71,56.79,21.92,23,21,44
2011-01-24 19:00:00,3,4,14.21,72.49,8.59,39,68,107
2011-01-24 20:00:00,1,4,32.15,40.87,4.53,26,148,174
2011-01-24 21:00:00,2,4,31.08,21.84,35.53,45,55,100
2011-01-24 22:00:00,3,1,12.13,31.3,19.29,21,83,104
2011-01-24 23:00:00,2,2,7.44,55.21,45.64,19,158,177
2011-01-25 00:00:00,1,2,23.81,42.56,27.01,32,100,132
2011-01-25 01:00:00,2,4,15.09,81.16,17.42,4,186,190
2011-01-25 02:00:00,2,1,25.16,28.54,17.45,28,197,225
2011-01-25 03:00:00,2,2,5.96,93.4,6.57,4,94,98
2011-01-25 04:00:00,2,2,9.0,91.63,29.69,45,170,215
2011-01-25 05:00:00,1,2,25.59,92.7,29.11,38,181,219
2011-01-25 06:00:00,4,1,11.37,79.17,40.0,16,145,161
2011-01-25 07:00:00,2,4,30.73,28.56,10.06,28,182,210
2011-01-25 08:00:00,2,4,6.76,55.05,14.54,10,28,38
2011-01-25 09:00:00,3,4,11.46,30.51,4.86,21,123,144
2011-01-25 10:00:00,2,3,34.96,99.02,14.77,30,188,218
2011-01-25 11:00:00,3,3,17.99,46.64,21.41,38,50,88
2011-01-25 12:00:00,4,3,26.09,66.83,48.2,0,75,75
2011-01-25 13:00:00,1,1,10.48,82.35,32.65,14,11,25
2011-01-25 14:00:00,1,2,23.3,93.65,39.14,18,92,110
2011-01-25 15:00:00,4,2,26.78,80.44,16.28,9,188,197
2011-01-25 16:00:00,1,1,14.43,73.96,7.23,8,70,78
2011-01-25 17:00:00,4,1,29.87,57.28,12.84,12,143,155
2011-01-25 18:00:00,4,4,23.1,68.43,12.82,44,127,171
2011-01-25 19:00:00,4,4,16.67,27.53,29.16,25,11,36
2011-01-25 20:00:00,1,3,21.73,90.71,17.07,5,61,66
2011-01-25 21:00:00,3,3,22.3,63.5,42.87,39,195,234
2011-01-25 22:00:00,4,1,9.97,23.21,49.43,43,105,148
2011-01-25 23:00:00,2,3,17.08,93.59,17.16,1,59,60
2011-01-26 00:00:00,1,2,15.3,59.14,35.25,28,80,108
2011-01-26 01:00:00,4,1,17.03,89.49,32.87,47,27,74
2011-01-26 02:00:00,4,1,27.83,88.55,9.72,11,63,74
2011-01-26 03:00:00,2,2,19.48,85.26,45.9,22,94,116
2011-01-26 04:00:00,3,4,33.21,24.91,9.97,49,71,120
2011-01-26 05:00:00,3,4,13.81,39.77,36.85,2,109,111
2011-01-26 06:00:00,3,2,17.47,90.04,17.38,49,177,226
2011-01-26 07:00:00,4,2,28.61,91.92,18.35,10,25,35
2011-01-26 08:00:00,4,3,21.38,56.65,22.77,4,167,171
2011-01-26 09:00:00,4,1,21.41,55.2,43.23,44,109,153
2011-01-26 10:00:00,1,3,6.6,34.01,7.01,9,182,191
2011-01-26 11:00:00,2,2,16.96,97.47,2.73,46,111,157
2011-01-26 12:00:00,4,3,13.12,37.05,20.1,5,158,163
2011-01-26 13:00:00,2,2,34.98,35.27,2.78,15,125,140
2011-01-26 14:00:00,2,3,14.25,72.86,34.38,30,70,100
2011-01-26 15:00:00,3,3,31.53,39.43,38.02,22,112,134
2011-01-26 16:00:00,1,4,25.29,95.1,42.74,29,4,33
2011-01-26 17:00:00,4,2,15.23,20.87,37.19,39,140,179
2011-01-26 18:00:00,3,3,21.31,20.46,45.82,19,145,164
2011-01-26 19:00:00,3,1,30.22,60.39,37.42,24,81,105
2011-01-26 20:00:00,4,3,31.5,59.04,46.8,34,118,152
2011-01-26 21:00:00,2,3,9.81,33.07,9.66,4,49,53
2011-01-26 22:00:00,3,1,15.19,59.56,24.99,46,127,173
2011-01-26 23:00:00,2,2,15.06,52.93,49.7,2,83,85
2011-01-27 00:00:00,1,4,6.26,91.23,34.08,46,112,158
2011-01-27 01:00:00,2,4,22.95,20.74,43.93,33,163,196
2011-01-27 02:00:00,1,4,30.64,98.1,1.52,11,112,123
2011-01-27 03:00:00,2,1,16.45,69.95,43.59,26,114,140
2011-01-27 04:00:00,3,3,27.2,32.15,34.89,4,103,107
2011-01-27 05:00:00,3,2,23.83,23.74,8.54,40,179,219
2011-01-27 06:00:00,1,3,16.27,63.05,1.28,21,32,53
2011-01-27 07:00:00,4,4,9.23,38.79,13.0,3,191,194
2011-01-27 08:00:00,1,3,26.28,44.09,45.79,27,198,225
2011-01-27 09:00:00,1,1,30.64,39.61,33.41,6,68,74
2011-01-27 10:00:00,2,1,25.58,72.01,45.97,47,95,142
2011-01-27 11:00:00,2,2,5.54,64.28,22.31,44,157,201
2011-01-27 12:00:00,1,2,11.49,26.24,46.83,33,95,128
2011-01-27 13:00:00,3,4,7.08,62.12,23.15,1,67,68
2011-01-27 14:00:00,2,2,22.11,83.3,10.21,8,21,29
2011-01-27 15:00:00,4,3,27.69,26.5,7.57,14,58,72
2011-01-27 16:00:00,2,1,8.32,91.18,49.69,30,7,37
2011-01-27 17:00:00,2,1,30.15,66.26,16.69,35,193,228
2011-01-27 18:00:00,4,1,21.67,96.05,8.0,48,36,84
2011-01-27 19:00:00,1,2,25.7,31.85,0.42,40,98,138
2011-01-27 20:00:00,4,1,34.14,99.49,14.28,14,55,69
2011-01-27 21:00:00,1,1,7.51,71.54,44.46,32,188,220
2011-01-27 22:00:00,1,1,32.04,65.4,26.7,30,85,115
2011-01-27 23:00:00,1,4,8.78,61.22,31.62,26,64,90
2011-01-28 00:00:00,4,4,16.79,21.89,46.12,1,102,103
2011-01-28 01:00:00,1,2,30.54,95.17,25.64,8,169,177
2011-01-28 02:00:00,3,1,32.19,71.52,41.91,42,111,153
2011-01-28 03:00:00,4,2,20.19,27.33,16.19,0,96,96
2011-01-28 04:00:00,3,1,22.82,21.68,48.86,18,176,194
2011-01-28 05:00:00,1,1,26.24,24.06,3.94,8,67,75
2011-01-28 06:00:00,2,1,29.98,68.75,36.24,1,136,137
2011-01-28 07:00:00,1,2,8.65,69.12,33.03,36,135,171
2011-01-28 08:00:00,3,2,29.3,59.97,9.58,48,57,105
2011-01-28 09:00:00,3,1,19.44,44.54,19.44,0,105,105
2011-01-28 10:00:00,4,3,18.52,62.54,15.64,45,53,98
2011-01-28 11:00:00,2,2,17.72,61.3,4.72,11,84,95
2011-01-28 12:00:00,4,4,20.28,21.55,29.24,25,47,72
2011-01-28 13:00:00,3,2,33.35,42.6,49.68,9,181,190
2011-01-28 14:00:00,1,1,21.45,24.25,27.98,46,104,150
2011-01-28 15:00:00,2,3,33.6,92.01,27.26,0,155,155
2011-01-28 16:00:00,1,1,10.41,78.02,2.02,0,100,100
2011-01-28 17:00:00,1,4,26.72,99.69,6.96,42,193,235
2011-01-28 18:00:00,2,2,29.37,44.17,25.66,30,109,139
2011-01-28 19:00:00,4,2,25.37,90.28,49.26,10,80,90
2011-01-28 20:00:00,1,1,23.21,68.24,43.83,4,127,131
2011-01-28 21:00:00,3,1,21.94,56.25,17.01,34,158,192
2011-01-28 22:00:00,1,4,30.83,37.81,27.15,10,140,150
2011-01-28 23:00:00,2,3,29.65,79.07,27.64,3,58,61
2011-01-29 00:00:00,2,4,8.67,92.33,34.27,37,81,118
2011-01-29 01:00:00,2,3,30.46,38.82,34.39,49,158,207
2011-01-29 02:00:00,4,2,17.42,34.03,39.49,38,32,70
2011-01-29 03:00:00,1,3,12.61,75.7,1.25,20,117,137
2011-01-29 04:00:00,4,3,31.09,98.16,47.18,35,52,87
2011-01-29 05:00:00,4,2,17.96,80.0,3.5,45,94,139
2011-01-29 06:00:00,2,2,29.25,42.77,23.81,27,121,148
2011-01-29 07:00:00,2,2,12.9,53.6,45.98,7,90,97
2011-01-29 08:00:00,4,4,5.12,50.75,24.38,19,120,139
2011-01-29 09:00:00,1,2,19.86,88.17,3.18,42,35,77
2011-01-29 10:00:00,3,1,8.01,81.71,11.46,45,196,241
2011-01-29 11:00:00,4,2,27.63,67.12,28.93,20,122,142
2011-01-29 12:00:00,1,2,13.28,42.0,4.39,34,33,67
2011-01-29 13:00:00,2,2,18.31,95.04,21.18,42,120,162
2011-01-29 14:00:00,2,3,7.61,72.27,16.45,31,60,91
2011-01-29 15:00:00,1,4,13.6,97.64,40.76,35,187,222
2011-01-29 16:00:00,3,2,28.44,66.41,5.51,40,2,42
2011-01-29 17:00:00,2,4,9.55,85.7,34.14,4,5,9
2011-01-29 18:00:00,2,1,24.41,85.05,20.33,44,147,191
2011-01-29 19:00:00,2,1,32.52,46.99,29.39,3,3,6
2011-01-29 20:00:00,1,2,25.4,97.12,10.28,6,100,106
2011-01-29 21:00:00,4,1,29.33,21.76,30.49,33,52,85
2011-01-29 22:00:00,2,4,8.27,81.5,33.7,19,102,121
2011-01-29 23:00:00,4,3,12.52,97.24,3.51,6,70,76
2011-01-30 00:00:00,3,2,31.84,47.11,41.22,23,189,212
2011-01-30 01:00:00,2,1,26.45,71.85,43.06,20,165,185
2011-01-30 02:00:00,2,4,24.19,64.98,3.18,8,163,171
2011-01-30 03:00:00,3,4,24.91,80.92,30.16,18,33,51
2011-01-30 04:00:00,2,1,17.43,89.29,29.7,19,5,24
2011-01-30 05:00:00,4,4,6.34,68.24,0.62,27,127,154
2011-01-30 06:00:00,1,4,28.53,85.27,17.12,31,193,224
2011-01-30 07:00:00,4,2,25.36,44.98,48.45,33,145,178
2011-01-30 08:00:00,1,4,19.18,38.29,27.77,15,26,41
2011-01-30 09:00:00,1,1,31.99,54.45,46.66,37,38,75
2011-01-30 10:00:00,4,2,15.08,74.22,33.78,49,50,99
2011-01-30 11:00:00,4,1,13.83,34.98,1.42,16,18,34
2011-01-30 12:00:00,4,3,31.18,74.43,3.89,10,95,105
2011-01-30 13:00:00,4,1,28.91,51.53,36.11,3,87,90
2011-01-30 14:00:00,3,1,20.45,83.65,27.73,39,161,200
2011-01-30 15:00:00,2,2,8.92,22.95,6.36,49,88,137
2011-01-30 16:00:00,1,4,11.45,73.44,30.7,44,23,67
2011-01-30 17:00:00,4,1,24.69,71.99,40.51,39,152,191
2011-01-30 18:00:00,4,2,16.55,95.27,37.65,41,75,116
2011-01-30 19:00:00,4,3,30.09,77.07,12.31,17,93,110
2011-01-30 20:00:00,3,2,33.5,83.7,12.91,49,197,246
2011-01-30 21:00:00,4,2,29.17,92.37,48.39,48,29,77
2011-01-30 22:00:00,4,4,16.33,74.0,44.37,47,53,100
2011-01-30 23:00:00,4,1,28.66,43.21,15.92,5,114,119
2011-01-31 00:00:00,2,3,15.54,89.58,41.2,45,77,122
2011-01-31 01:00:00,3,2,10.01,79.81,8.09,31,119,150
2011-01-31 02:00:00,4,1,6.0,53.96,9.84,4,24,28
2011-01-31 03:00:00,1,1,16.57,76.84,9.06,14,124,138
2011-01-31 04:00:00,1,2,32.11,89.42,4.39,44,4,48
2011-01-31 05:00:00,1,1,12.17,98.05,42.73,15,1,16
2011-01-31 06:00:00,3,2,11.2,96.19,28.94,47,110,157
2011-01-31 07:00:00,3,2,34.09,46.03,12.95,16,79,95
2011-01-31 08:00:00,1,2,5.75,53.74,42.43,36,102,138
2011-01-31 09:00:00,4,3,28.57,28.76,40.13,42,190,232
2011-01-31 10:00:00,3,2,14.64,39.8,5.05,14,123,137
2011-01-31 11:00:00,1,4,6.12,90.59,32.21,34,181,215
2011-01-31 12:00:00,1,1,32.53,48.87,36.09,7,165,172
2011-01-31 13:00:00,4,3,9.19,69.64,35.79,34,123,157
2011-01-31 14:00:00,2,1,21.55,73.28,36.16,35,16,51
2011-01-31 15:00:00,3,3,13.22,82.55,8.47,26,30,56
2011-01-31 16:00:00,4,4,6.96,34.62,15.75,13,128,141
2011-01-31 17:00:00,1,3,6.5,44.39,42.21,22,133,155
2011-01-31 18:00:00,1,3,8.47,55.87,44.92,19,69,88
2011-01-31 19:00:00,4,3,7.14,49.19,13.96,5,35,40
2011-01-31 20:00:00,3,1,27.82,98.63,1.15,23,135,158
2011-01-31 21:00:00,2,2,19.57,86.8,42.99,22,92,114
2011-01-31 22:00:00,2,1,15.29,58.37,18.85,35,72,107
2011-01-31 23:00:00,1,2,17.55,90.34,16.47,11,137,148
2011-02-01 00:00:00,3,1,32.87,47.81,17.35,1,23,24
2011-02-01 01:00:00,2,4,32.32,82.87,20.78,26,190,216
2011-02-01 02:00:00,3,4,26.47,37.89,18.91,31,167,198
2011-02-01 03:00:00,3,3,31.54,81.79,28.32,28,1,29
2011-02-01 04:00:00,1,4,14.59,56.52,3.95,49,19,68
2011-02-01 05:00:00,2,3,16.43,28.6,48.58,45,32,77
2011-02-01 06:00:00,4,2,23.41,41.86,46.82,39,13,52
2011-02-01 07:00:00,1,4,23.71,52.18,46.72,39,181,220
2011-02-01 08:00:00,2,2,19.45,79.94,43.96,43,54,97
2011-02-01 09:00:00,2,1,17.02,25.84,33.02,32,36,68
2011-02-01 10:00:00,2,2,34.59,72.76,11.06,28,104,132
2011-02-01 11:00:00,2,1,29.63,77.28,2.47,32,83,115
2011-02-01 12:00:00,2,2,18.05,72.31,4.97,35,112,147
2011-02-01 13:00:00,3,2,26.82,80.85,16.2,16,133,149
2011-02-01 14:00:00,1,4,13.09,34.25,25.19,9,160,169
2011-02-01 15:00:00,3,2,8.01,66.97,49.66,0,127,127
2011-02-01 16:00:00,4,4,15.57,95.29,21.77,42,49,91
2011-02-01 17:00:00,2,4,17.09,68.86,26.23,16,83,99
2011-02-01 18:00:00,1,3,5.5,68.91,34.76,41,197,238
2011-02-01 19:00:00,2,3,29.44,78.92,9.04,27,199,226
2011-02-01 20:00:00,1,1,15.78,46.66,46.64,37,78,115
2011-02-01 21:00:00,3,2,22.41,76.04,26.45,35,85,120
2011-02-01 22:00:00,1,1,7.22,93.3,13.81,44,178,222
2011-02-01 23:00:00,4,2,10.25,20.87,46.76,26,193,219
2011-02-02 00:00:00,4,3,31.69,89.61,31.27,42,188,230
2011-02-02 01:00:00,1,3,23.26,37.49,24.18,36,155,191
2011-02-02 02:00:00,1,2,33.51,56.47,29.01,45,99,144
2011-02-02 03:00:00,1,2,34.96,88.19,37.42,24,171,195
2011-02-02 04:00:00,1,3,16.16,85.91,7.73,33,139,172
2011-02-02 05:00:00,4,3,13.96,91.35,43.24,2,56,58
2011-02-02 06:00:00,2,1,30.75,95.23,47.98,28,153,181
2011-02-02 07:00:00,1,3,34.96,55.77,28.35,34,24,58
2011-02-02 08:00:00,1,2,23.89,72.51,34.11,42,14,56
2011-02-02 09:00:00,4,1,28.85,51.24,42.99,40,102,142
2011-02-02 10:00:00,4,2,28.45,48.06,18.74,9,97,106
2011-02-02 11:00:00,3,4,15.66,54.53,49.64,37,76,113
2011-02-02 12:00:00,1,1,22.23,79.45,34.03,37,180,217
2011-02-02 13:00:00,3,2,29.99,60.12,21.2,0,103,103
2011-02-02 14:00:00,4,3,25.64,85.12,33.87,0,64,64
2011-02-02 15:00:00,4,4,5.63,79.62,26.08,31,112,143
2011-02-02 16:00:00,2,2,15.1,21.64,5.58,21,122,143
2011-02-02 17:00:00,1,1,9.33,70.42,39.79,18,110,128
2011-02-02 18:00:00,3,2,11.99,54.93,28.22,34,122,156
2011-02-02 19:00:00,4,4,32.16,56.53,39.79,5,53,58
2011-02-02 20:00:00,4,1,6.11,85.47,7.75,33,166,199
2011-02-02 21:00:00,3,4,11.59,63.81,26.92,14,178,192
2011-02-02 22:00:00,2,2,14.29,90.85,38.33,43,19,62
2011-02-02 23:00:00,4,3,23.51,77.02,49.42,41,191,232
2011-02-03 00:00:00,1,3,21.02,64.23,44.22,44,88,132
2011-02-03 01:00:00,4,2,11.55,80.36,43.22,2,10,12
2011-02-03 02:00:00,1,2,9.93,23.07,12.37,49,126,175
2011-02-03 03:00:00,3,2,12.1,22.17,41.9,36,51,87
2011-02-03 04:00:00,1,1,20.08,26.67,8.46,21,53,74
2011-02-03 05:00:00,3,4,13.14,55.01,9.91,44,68,112
2011-02-03 06:00:00,1,4,33.43,38.84,5.51,28,6,34
2011-02-03 07:00:00,3,4,18.92,98.74,42.88,13,139,152
2011-02-03 08:00:00,1,2,6.76,63.38,5.41,29,129,158
2011-02-03 09:00:00,2,4,26.88,72.99,6.91,14,102,116
2011-02-03 10:00:00,1,2,14.87,42.31,12.29,49,148,197
2011-02-03 11:00:00,1,1,24.6,45.74,28.63,28,68,96
2011-02-03 12:00:00,2,3,13.39,46.84,44.01,13,90,103
2011-02-03 13:00:00,4,2,22.12,75.9,20.91,2,94,96
2011-02-03 14:00:00,4,2,28.16,57.9,27.31,21,117,138
2011-02-03 15:00:00,1,3,32.84,61.41,8.32,32,120,152
2011-02-03 16:00:00,2,3,12.83,67.36,13.3,22,35,57
2011-02-03 17:00:00,1,1,15.05,81.5,6.7,6,20,26
2011-02-03 18:00:00,3,4,18.93,27.23,20.5,19,52,71
2011-02-03 19:00:00,3,2,32.82,82.15,29.52,6,146,152
2011-02-03 20:00:00,1,4,32.04,65.06,14.2,16,2,18
2011-02-03 21:00:00,4,2,7.7,73.53,42.3,31,187,218
2011-02-03 22:00:00,4,1,8.96,46.2,49.06,14,80,94
2011-02-03 23:00:00,1,3,19.87,52.75,6.01,12,93,105
2011-02-04 00:00:00,1,1,8.2,38.49,0.89,46,99,145
2011-02-04 01:00:00,3,3,15.37,98.34,39.49,2,161,163
2011-02-04 02:00:00,4,4,9.45,59.76,9.53,24,156,180
2011-02-04 03:00:00,1,4,24.08,99.69,17.66,48,115,163
2011-02-04 04:00:00,3,1,33.48,59.18,19.71,31,184,215
2011-02-04 05:00:00,4,3,34.9,37.58,45.83,15,72,87
2011-02-04 06:00:00,2,1,16.26,60.6,32.94,0,39,39
2011-02-04 07:00:00,3,3,22.97,23.17,2.03,45,49,94
2011-02-04 08:00:00,4,3,30.69,92.38,0.74,2,146,148
2011-02-04 09:00:00,4,4,8.52,85.48,9.98,19,149,168
2011-02-04 10:00:00,3,4,25.69,78.07,15.91,27,178,205
2011-02-04 11:00:00,2,3,17.27,68.79,24.23,21,48,69
2011-02-04 12:00:00,3,3,11.18,66.39,41.89,35,179,214
2011-02-04 13:00:00,4,3,17.08,99.74,15.74,40,122,162
2011-02-04 14:00:00,1,4,7.28,42.24,18.83,0,149,149
2011-02-04 15:00:00,1,4,25.86,82.37,16.47,13,112,125
2011-02-04 16:00:00,3,2,12.58,66.51,0.45,44,189,233
2011-02-04 17:00:00,4,3,14.34,98.07,47.76,14,59,73
2011-02-04 18:00:00,1,2,8.63,86.22,6.95,31,6,37
2011-02-04 19:00:00,4,3,30.94,99.88,14.38,17,118,135
2011-02-04 20:00:00,3,4,19.8,67.07,6.47,47,180,227
2011-02-04 21:00:00,1,2,22.16,36.36,24.53,37,30,67
2011-02-04 22:00:00,4,2,22.08,60.29,46.61,21,131,152
2011-02-04 23:00:00,1,1,17.31,76.89,5.04,15,92,107
2011-02-05 00:00:00,3,3,10.78,81.95,22.04,10,6,16
2011-02-05 01:00:00,4,4,27.35,20.04,1.12,6,130,136
2011-02-05 02:00:00,1,1,8.81,60.4,38.54,8,24,32
2011-02-05 03:00:00,3,1,8.12,38.82,32.06,0,161,161
2011-02-05 04:00:00,1,3,26.3,89.99,34.98,41,32,73
2011-02-05 05:00:00,1,1,11.27,32.23,23.62,7,94,101
2011-02-05 06:00:00,2,3,14.2,73.32,45.38,10,87,97
2011-02-05 07:00:00,2,1,19.26,41.28,20.48,4,125,129
2011-02-05 08:00:00,3,3,18.48,48.52,25.7,28,37,65
2011-02-05 09:00:00,2,4,26.26,95.24,34.76,5,109,114
2011-02-05 10:00:00,3,3,23.7,39.24,26.03,11,124,135
2011-02-05 11:00:00,2,3,24.33,27.6,9.47,42,125,167
2011-02-05 12:00:00,1,2,26.42,25.54,15.85,38,3,41
2011-02-05 13:00:00,3,4,13.78,60.37,4.61,6,175,181
2011-02-05 14:00:00,3,4,14.67,71.34,21.63,43,100,143
2011-02-05 15:00:00,1,4,18.14,46.18,30.47,11,60,71
2011-02-05 16:00:00,3,1,14.22,75.22,5.93,32,192,224
2011-02-05 17:00:00,3,2,34.55,24.88,31.53,18,80,98
2011-02-05 18:00:00,2,4,29.42,88.59,44.64,35,109,144
2011-02-05 19:00:00,3,1,9.94,85.33,16.89,18,198,216
2011-02-05 20:00:00,4,1,5.17,98.84,11.1,20,77,97
2011-02-05 21:00:00,1,1,6.28,94.92,44.65,18,60,78
2011-02-05 22:00:00,2,2,12.32,48.5,34.6,42,128,170
2011-02-05 23:00:00,2,1,8.43,51.94,5.27,8,5,13
2011-02-06 00:00:00,4,2,21.0,79.68,20.41,44,20,64
2011-02-06 01:00:00,1,3,30.74,30.73,33.7,21,194,215
2011-02-06 02:00:00,1,1,27.1,45.12,28.72,18,82,100
2011-02-06 03:00:00,2,4,11.47,29.48,30.93,36,27,63
2011-02-06 04:00:00,3,1,16.98,56.39,28.36,10,193,203
2011-02-06 05:00:00,2,3,20.24,64.16,39.9,24,154,178
2011-02-06 06:00:00,1,3,29.31,36.89,16.02,34,159,193
2011-02-06 07:00:00,4,1,30.17,22.13,35.42,4,139,143
2011-02-06 08:00:00,2,3,32.29,77.55,49.55,44,64,108
2011-02-06 09:00:00,1,2,20.28,21.6,19.5,30,173,203
2011-02-06 10:00:00,2,2,25.83,97.87,39.55,13,167,180
2011-02-06 11:00:00,3,1,8.35,37.73,12.31,12,92,104
2011-02-06 12:00:00,2,2,21.96,73.11,14.09,33,136,169
2011-02-06 13:00:00,2,2,12.46,54.78,46.74,33,81,114
2011-02-06 14:00:00,1,4,17.95,24.77,1.3,17,61,78
2011-02-06 15:00:00,1,1,24.02,57.77,10.87,5,108,113
2011-02-06 16:00:00,1,3,12.71,61.34,24.15,41,143,184
2011-02-06 17:00:00,2,1,6.57,88.37,20.09,20,98,118
2011-02-06 18:00:00,3,2,5.31,78.59,31.46,39,99,138
2011-02-06 19:00:00,4,4,5.66,26.34,9.64,4,195,199
2011-02-06 20:00:00,4,1,5.25,36.73,3.53,1,167,168
2011-02-06 21:00:00,1,1,8.31,44.95,18.47,5,34,39
2011-02-06 22:00:00,1,2,12.18,29.31,26.22,49,126,175
2011-02-06 23:00:00,2,2,11.64,56.55,28.1,7,82,89
2011-02-07 00:00:00,4,1,34.6,98.74,30.07,1,187,188
2011-02-07 01:00:00,1,2,14.18,61.17,27.43,22,197,219
2011-02-07 02:00:00,3,2,8.82,79.35,12.29,19,90,109
2011-02-07 03:00:00,3,2,21.37,74.64,38.23,3,2,5
2011-02-07 04:00:00,1,2,30.74,87.99,4.39,14,127,141
2011-02-07 05:00:00,1,2,25.34,37.26,9.92,29,52,81
2011-02-07 06:00:00,4,4,13.88,80.31,36.97,19,99,118
2011-02-07 07:00:00,4,2,21.85,90.51,13.99,23,186,209
2011-02-07 08:00:00,2,3,26.45,33.72,24.67,8,163,171
2011-02-07 09:00:00,4,1,26.84,47.74,16.36,20,193,213
2011-02-07 10:00:00,3,4,25.0,97.61,25.35,37,36,73
2011-02-07 11:00:00,3,4,31.12,82.46,17.33,40,100,140
2011-02-07 12:00:00,1,2,31.1,42.61,49.71,12,43,55
2011-02-07 13:00:00,4,1,22.37,65.12,17.87,4,63,67
2011-02-07 14:00:00,2,3,17.9,52.35,31.35,45,178,223
2011-02-07 15:00:00,3,2,24.25,59.2,44.42,13,123,136
2011-02-07 16:00:00,3,1,29.55,48.41,31.9,49,5,54
2011-02-07 17:00:00,2,2,5.17,42.35,28.29,6,68,74
2011-02-07 18:00:00,2,2,34.76,73.98,28.46,5,148,153
2011-02-07 19:00:00,3,2,10.49,82.28,24.82,11,56,67
2011-02-07 20:00:00,3,2,19.11,89.92,40.38,45,155,200
2011-02-07 21:00:00,2,2,31.16,32.43,2.52,15,84,99
2011-02-07 22:00:00,3,2,11.75,85.83,44.26,31,23,54
2011-02-07 23:00:00,1,2,19.3,40.38,29.31,41,114,155
2011-02-08 00:00:00,1,3,8.98,54.19,42.44,10,91,101
2011-02-08 01:00:00,2,4,16.85,92.12,0.52,3,74,77
2011-02-08 02:00:00,4,3,10.31,56.36,43.46,28,190,218
2011-02-08 03:00:00,2,2,15.91,35.77,6.01,33,21,54
2011-02-08 04:00:00,2,2,16.2,32.79,36.06,8,109,117
2011-02-08 05:00:00,4,3,34.8,57.84,20.83,9,33,42
2011-02-08 06:00:00,4,3,34.84,81.01,34.05,7,117,124
2011-02-08 07:00:00,4,4,8.44,99.78,31.41,35,36,71
2011-02-08 08:00:00,1,3,26.78,82.99,8.17,31,40,71
2011-02-08 09:00:00,3,4,6.55,90.16,25.73,44,78,122
2011-02-08 10:00:00,1,2,5.91,79.83,13.86,5,104,109
2011-02-08 11:00:00,3,1,8.16,91.63,28.02,5,42,47
2011-02-08 12:00:00,1,1,33.96,26.1,36.9,26,21,47
2011-02-08 13:00:00,3,1,33.23,94.39,4.06,1,90,91
2011-02-08 14:00:00,1,1,10.82,51.71,25.79,8,142,150
2011-02-08 15:00:00,4,2,9.85,93.73,30.88,37,20,57
2011-02-08 16:00:00,2,1,12.22,26.06,14.77,4,51,55
2011-02-08 17:00:00,1,3,20.47,77.22,47.65,33,3,36
2011-02-08 18:00:00,3,3,22.09,78.86,26.02,13,174,187
2011-02-08 19:00:00,4,1,11.65,99.75,9.13,9,145,154
2011-02-08 20:00:00,1,3,27.7,81.51,5.39,46,70,116
2011-02-08 21:00:00,1,4,14.29,50.61,27.08,48,117,165
2011-02-08 22:00:00,4,2,32.66,64.58,18.76,6,162,168
2011-02-08 23:00:00,1,1,24.7,49.32,9.63,19,6,25
2011-02-09 00:00:00,2,1,18.09,35.68,1.53,10,168,178
2011-02-09 01:00:00,1,2,28.7,39.88,28.33,12,137,149
2011-02-09 02:00:00,2,3,29.54,37.76,29.93,16,189,205
2011-02-09 03:00:00,2,2,13.71,63.91,7.09,36,192,228
2011-02-09 04:00:00,4,2,15.19,92.49,30.09,43,139,182
2011-02-09 05:00:00,1,3,33.08,93.02,47.6,35,90,125
2011-02-09 06:00:00,4,2,9.94,24.38,48.91,32,155,187
2011-02-09 07:00:00,1,3,6.26,26.39,44.42,9,57,66
2011-02-09 08:00:00,1,3,18.62,39.61,40.35,33,183,216
2011-02-09 09:00:00,3,2,29.04,40.4,10.47,44,145,189
2011-02-09 10:00:00,1,4,28.15,27.59,7.82,12,192,204
2011-02-09 11:00:00,4,3,32.59,51.08,22.25,24,184,208
2011-02-09 12:00:00,2,2,21.0,67.02,30.98,43,177,220
2011-02-09 13:00:00,1,3,8.0,66.25,42.53,32,126,158
2011-02-09 14:00:00,3,4,22.66,63.47,11.6,9,44,53
2011-02-09 15:00:00,4,4,28.35,47.09,23.98,23,189,212
2011-02-09 16:00:00,1,1,7.8,76.52,32.37,4,105,109
2011-02-09 17:00:00,4,3,10.18,86.12,22.28,9,109,118
2011-02-09 18:00:00,3,3,5.37,47.7,22.71,38,192,230
2011-02-09 19:00:00,3,2,22.81,26.84,11.26,46,54,100
2011-02-09 20:00:00,4,3,31.6,43.71,49.33,26,37,63
2011-02-09 21:00:00,1,1,25.12,30.99,23.76,49,3,52
2011-02-09 22:00:00,2,4,34.46,57.39,26.64,35,14,49
2011-02-09 23:00:00,3,4,6.89,32.47,10.93,32,148,180
2011-02-10 00:00:00,1,1,32.09,57.03,25.71,27,148,175
2011-02-10 01:00:00,1,3,29.42,37.68,12.77,39,178,217
2011-02-10 02:00:00,2,3,14.43,79.1,10.12,42,107,149
2011-02-10 03:00:00,3,1,34.21,22.21,13.79,2,34,36
2011-02-10 04:00:00,3,2,13.64,64.38,0.14,30,124,154
2011-02-10 05:00:00,1,4,31.68,33.56,28.51,28,3,31
2011-02-10 06:00:00,1,1,31.42,20.08,19.37,43,159,202
2011-02-10 07:00:00,2,1,27.73,89.54,44.93,44,139,183
2011-02-10 08:00:00,2,3,21.9,73.72,2.04,49,53,102
2011-02-10 09:00:00,3,4,8.6,27.92,2.16,43,29,72
2011-02-10 10:00:00,4,3,20.96,73.13,44.29,41,8,49
2011-02-10 11:00:00,3,1,15.7,68.93,6.33,20,18,38
2011-02-10 12:00:00,1,2,28.77,57.87,0.11,31,79,110
2011-02-10 13:00:00,3,4,27.74,53.54,8.95,27,157,184
2011-02-10 14:00:00,4,1,32.32,90.97,41.19,20,192,212
2011-02-10 15:00:00,2,1,5.44,39.61,40.14,46,109,155
2011-02-10 16:00:00,4,2,29.27,51.86,17.01,34,44,78
2011-02-10 17:00:00,4,1,33.15,46.33,33.4,29,22,51
2011-02-10 18:00:00,4,1,28.68,81.7,25.36,46,75,121
2011-02-10 19:00:00,2,4,8.91,93.32,45.24,16,4,20
2011-02-10 20:00:00,4,4,7.44,87.98,2.82,28,194,222
2011-02-10 21:00:00,4,4,5.63,83.82,40.66,47,118,165
2011-02-10 22:00:00,4,3,23.86,98.94,8.53,1,193,194
2011-02-10 23:00:00,1,2,23.89,75.77,19.58,32,42,74
2011-02-11 00:00:00,4,4,34.61,80.08,9.6,3,1,4
2011-02-11 01:00:00,2,3,16.94,98.62,35.13,48,175,223
2011-02-11 02:00:00,4,3,14.96,20.56,33.92,38,185,223
2011-02-11 03:00:00,4,2,23.73,70.72,27.39,24,39,63
2011-02-11 04:00:00,2,2,29.77,79.12,34.91,4,98,102
2011-02-11 05:00:00,4,1,33.1,93.43,31.98,3,180,183
2011-02-11 06:00:00,2,3,29.09,90.71,38.82,28,186,214
2011-02-11 07:00:00,4,4,17.8,87.36,11.97,36,195,231
2011-02-11 08:00:00,2,2,24.05,95.66,21.45,7,190,197
2011-02-11 09:00:00,4,3,30.69,62.99,7.58,19,116,135
2011-02-11 10:00:00,4,4,19.72,20.55,21.48,40,163,203
2011-02-11 11:00:00,1,3,11.5,20.88,35.08,5,39,44
2011-02-11 12:00:00,1,2,10.09,63.57,34.57,35,133,168
2011-02-11 13:00:00,4,1,5.0,54.82,35.47,31,141,172
2011-02-11 14:00:00,4,3,26.55,56.1,15.44,4,124,128
2011-02-11 15:00:00,3,4,8.33,52.03,33.11,39,100,139
2011-02-11 16:00:00,2,2,12.32,93.42,18.37,19,32,51
2011-02-11 17:00:00,3,1,13.94,48.73,47.22,44,107,151
2011-02-11 18:00:00,1,4,21.81,88.5,17.17,3,146,149
2011-02-11 19:00:00,1,4,16.94,92.23,30.15,38,170,208
2011-02-11 20:00:00,1,4,25.24,59.96,37.51,21,53,74
2011-02-11 21:00:00,1,3,6.67,55.76,45.32,32,95,127
2011-02-11 22:00:00,4,2,8.72,80.88,21.9,30,91,121
2011-02-11 23:00:00,1,4,19.98,76.64,18.02,40,91,131
2011-02-12 00:00:00,4,3,15.11,46.28,21.5,28,123,151
2011-02-12 01:00:00,4,2,13.87,28.2,16.18,4,94,98
2011-02-12 02:00:00,1,2,7.01,41.19,32.7,9,60,69
2011-02-12 03:00:00,1,3,31.87,30.48,46.64,10,140,150
2011-02-12 04:00:00,2,3,25.75,43.58,6.3,49,169,218
2011-02-12 05:00:00,3,4,8.65,40.95,28.05,36,17,53
2011-02-12 06:00:00,1,2,6.95,71.02,44.88,21,108,129
2011-02-12 07:00:00,2,1,34.25,96.36,5.01,23,71,94
2011-02-12 08:00:00,2,3,25.44,74.86,24.69,20,112,132
2011-02-12 09:00:00,3,2,17.52,94.13,43.26,35,192,227
2011-02-12 10:00:00,4,2,26.05,82.73,45.02,15,47,62
2011-02-12 11:00:00,1,4,27.69,78.23,25.72,1,94,95
2011-02-12 12:00:00,3,1,28.4,53.12,1.25,14,83,97
2011-02-12 13:00:00,1,4,19.34,45.98,5.28,40,163,203
2011-02-12 14:00:00,2,1,17.9,87.7,29.34,48,86,134
2011-02-12 15:00:00,2,1,5.33,92.43,6.19,25,172,197
2011-02-12 16:00:00,4,3,32.8,56.15,7.47,29,137,166
2011-02-12 17:00:00,2,2,23.1,20.73,38.61,1,136,137
2011-02-12 18:00:00,2,2,11.09,83.4,37.53,28,173,201
2011-02-12 19:00:00,3,2,32.59,42.81,42.14,5,144,149
2011-02-12 20:00:00,1,1,32.45,20.79,5.29,0,194,194
2011-02-12 21:00:00,1,2,34.68,84.4,9.91,39,32,71
2011-02-12 22:00:00,3,3,31.22,61.39,41.65,10,64,74
2011-02-12 23:00:00,4,1,34.93,74.82,36.05,22,147,169
2011-02-13 00:00:00,1,1,12.34,93.18,40.3,25,193,218
2011-02-13 01:00:00,2,1,30.27,63.29,49.49,30,125,155
2011-02-13 02:00:00,1,1,29.69,60.26,43.22,14,143,157
2011-02-13 03:00:00,2,3,11.93,43.25,26.02,8,141,149
2011-02-13 04:00:00,4,2,7.95,44.42,15.54,33,128,161
2011-02-13 05:00:00,3,3,34.38,83.72,28.48,38,162,200
2011-02-13 06:00:00,1,2,13.88,55.92,31.93,16,128,144
2011-02-13 07:00:00,3,3,31.13,33.08,16.77,34,170,204
2011-02-13 08:00:00,1,4,5.12,27.56,38.55,35,68,103
2011-02-13 09:00:00,2,4,5.63,57.83,4.64,2,74,76
2011-02-13 10:00:00,3,4,18.98,57.2,38.97,39,95,134
2011-02-13 11:00:00,1,4,12.16,72.28,1.6,10,182,192
2011-02-13 12:00:00,2,1,25.7,57.69,24.9,27,143,170
2011-02-13 13:00:00,3,1,21.97,31.48,43.07,47,120,167
2011-02-13 14:00:00,3,3,7.32,60.62,4.32,27,194,221
2011-02-13 15:00:00,1,3,9.88,92.54,25.89,45,110,155
2011-02-13 16:00:00,1,4,16.64,32.76,7.97,18,190,208
2011-02-13 17:00:00,1,2,10.57,75.18,44.74,1,71,72
2011-02-13 18:00:00,2,4,28.77,67.51,41.62,31,149,180
2011-02-13 19:00:00,1,3,17.48,79.89,46.7,43,183,226
2011-02-13 20:00:00,3,4,7.8,32.05,43.75,10,51,61
2011-02-13 21:00:00,3,3,19.53,95.33,36.83,15,154,169
2011-02-13 22:00:00,1,4,7.73,69.68,9.24,10,63,73
2011-02-13 23:00:00,1,2,8.87,87.77,15.13,2,44,46
2011-02-14 00:00:00,4,4,12.19,39.73,24.84,41,194,235
2011-02-14 01:00:00,3,2,30.79,79.15,29.44,28,25,53
2011-02-14 02:00:00,2,2,32.74,82.48,39.11,4,140,144
2011-02-14 03:00:00,4,3,29.79,51.79,11.35,27,157,184
2011-02-14 04:00:00,1,2,15.02,50.72,6.41,30,77,107
2011-02-14 05:00:00,1,1,13.17,72.62,24.13,12,29,41
2011-02-14 06:00:00,3,1,21.47,27.47,7.89,24,171,195
2011-02-14 07:00:00,1,1,26.66,78.85,34.69,5,175,180
2011-02-14 08:00:00,2,3,34.8,23.43,28.78,2,101,103
2011-02-14 09:00:00,3,1,8.95,35.25,37.06,21,8,29
2011-02-14 10:00:00,1,3,6.48,73.13,3.17,40,175,215
2011-02-14 11:00:00,3,3,25.83,27.87,48.23,38,95,133
2011-02-14 12:00:00,1,1,29.97,97.75,0.0,31,183,214
2011-02-14 13:00:00,1,2,30.39,89.47,16.27,29,67,96
2011-02-14 14:00:00,1,4,25.35,70.1,33.98,6,133,139
2011-02-14 15:00:00,2,3,33.62,85.52,2.26,24,192,216
2011-02-14 16:00:00,2,1,20.33,91.01,4.17,1,88,89
2011-02-14 17:00:00,3,3,32.41,40.76,3.83,7,194,201
2011-02-14 18:00:00,1,2,34.03,87.95,29.08,49,20,69
2011-02-14 19:00:00,1,2,30.41,35.58,44.8,32,77,109
2011-02-14 20:00:00,2,1,14.29,53.07,27.77,27,29,56
2011-02-14 21:00:00,1,3,10.89,64.66,30.18,9,56,65
2011-02-14 22:00:00,2,4,21.44,77.11,17.3,37,54,91
2011-02-14 23:00:00,1,4,18.59,22.41,0.94,17,1,18
2011-02-15 00:00:00,3,3,31.33,43.24,1.08,12,47,59
2011-02-15 01:00:00,1,3,8.0,68.68,44.42,20,21,41
2011-02-15 02:00:00,1,3,12.73,48.59,5.13,32,140,172
2011-02-15 03:00:00,4,1,27.55,82.0,49.99,22,88,110
2011-02-15 04:00:00,2,2,7.85,72.13,8.22,0,111,111
2011-02-15 05:00:00,1,4,14.62,38.75,33.73,43,42,85
2011-02-15 06:00:00,1,1,16.61,31.67,47.45,39,74,113
2011-02-15 07:00:00,4,3,23.68,70.32,18.11,20,73,93
2011-02-15 08:00:00,4,3,9.74,56.04,36.72,4,48,52
2011-02-15 09:00:00,2,2,30.82,33.52,17.54,34,164,198
2011-02-15 10:00:00,4,3,18.43,46.11,15.25,17,107,124
2011-02-15 11:00:00,3,1,32.51,44.24,10.09,37,34,71
2011-02-15 12:00:00,4,1,19.04,28.65,41.05,35,18,53
2011-02-15 13:00:00,3,2,13.25,63.75,12.87,46,27,73
2011-02-15 14:00:00,2,1,9.25,81.09,14.16,28,105,133
2011-02-15 15:00:00,2,4,5.11,66.04,49.95,25,111,136
2011-02-15 16:00:00,2,1,20.96,86.1,16.37,35,184,219
2011-02-15 17:00:00,2,1,8.21,30.21,21.14,37,114,151
2011-02-15 18:00:00,2,1,16.75,54.85,49.5,49,188,237
2011-02-15 19:00:00,3,4,22.68,68.75,18.47,17,170,187
2011-02-15 20:00:00,3,3,13.27,74.08,18.31,28,120,148
2011-02-15 21:00:00,2,1,10.26,75.66,41.39,30,187,217
2011-02-15 22:00:00,4,2,28.24,78.32,15.6,41,137,178
2011-02-15 23:00:00,1,4,33.4,72.11,11.69,12,78,90
2011-02-16 00:00:00,2,2,8.01,27.54,21.16,49,95,144
2011-02-16 01:00:00,4,1,9.67,75.62,35.03,29,194,223
2011-02-16 02:00:00,1,2,33.8,77.98,2.16,6,23,29
2011-02-16 03:00:00,2,1,6.13,99.48,18.7,39,127,166
2011-02-16 04:00:00,2,4,34.33,75.47,17.31,5,171,176
2011-02-16 05:00:00,3,2,5.14,74.95,12.24,1,157,158
2011-02-16 06:00:00,1,2,31.21,61.19,32.71,7,114,121
2011-02-16 07:00:00,1,1,14.22,89.43,14.5,9,44,53
2011-02-16 08:00:00,4,1,33.16,99.75,30.34,48,117,165
2011-02-16 09:00:00,3,3,14.51,82.32,25.22,43,59,102
2011-02-16 10:00:00,3,1,24.63,69.0,10.86,42,115,157
2011-02-16 11:00:00,3,1,7.4,26.32,13.33,48,52,100
2011-02-16 12:00:00,3,3,12.27,78.14,8.53,47,102,149
2011-02-16 13:00:00,1,1,28.21,76.68,2.83,21,24,45
2011-02-16 14:00:00,1,1,20.86,82.05,30.96,9,101,110
2011-02-16 15:00:00,2,3,32.84,29.96,33.64,34,131,165
2011-02-16 16:00:00,2,4,17.86,72.3,8.3,18,91,109
2011-02-16 17:00:00,3,4,31.09,43.66,30.77,3,30,33
2011-02-16 18:00:00,3,1,18.47,80.82,49.1,18,146,164
2011-02-16 19:00:00,3,1,34.38,39.23,3.72,40,1,41
2011-02-16 20:00:00,2,3,33.8,74.72,24.52,19,3,22
2011-02-16 21:00:00,4,3,14.87,43.6,36.65,48,78,126
2011-02-16 22:00:00,4,4,31.58,20.72,2.3,3,37,40
2011-02-16 23:00:00,2,2,30.43,70.67,38.91,48,32,80
2011-02-17 00:00:00,2,1,11.32,29.06,48.98,25,17,42
2011-02-17 01:00:00,2,2,23.73,72.74,4.42,2,103,105
2011-02-17 02:00:00,2,2,7.18,94.05,41.11,29,159,188
2011-02-17 03:00:00,2,3,30.1,97.54,18.93,35,114,149
2011-02-17 04:00:00,2,1,10.24,38.87,7.21,40,160,200
2011-02-17 05:00:00,3,1,7.12,84.74,24.66,5,33,38
2011-02-17 06:00:00,3,3,17.01,48.28,3.58,38,50,88
2011-02-17 07:00:00,3,2,22.31,92.04,26.11,26,62,88
2011-02-17 08:00:00,3,3,30.65,83.0,0.97,15,46,61
2011-02-17 09:00:00,2,4,34.23,25.91,36.43,46,193,239
2011-02-17 10:00:00,4,1,18.18,52.57,24.4,15,140,155
2011-02-17 11:00:00,1,4,6.81,46.99,22.95,45,51,96
2011-02-17 12:00:00,2,3,27.47,82.81,9.81,35,92,127
2011-02-17 13:00:00,1,1,21.96,52.82,18.06,33,51,84
2011-02-17 14:00:00,4,4,18.44,74.77,9.09,38,170,208
2011-02-17 15:00:00,3,4,14.28,68.19,36.77,23,105,128
2011-02-17 16:00:00,4,2,20.07,98.05,9.95,38,97,135
2011-02-17 17:00:00,2,1,15.16,95.02,30.84,5,188,193
2011-02-17 18:00:00,3,4,27.71,54.22,13.98,19,130,149
2011-02-17 19:00:00,2,4,21.32,77.89,32.85,8,195,203
2011-02-17 20:00:00,3,2,31.31,86.36,27.02,48,58,106
2011-02-17 21:00:00,1,4,21.31,91.91,21.17,20,126,146
2011-02-17 22:00:00,1,4,12.15,25.45,33.65,10,181,191
2011-02-17 23:00:00,1,4,30.53,44.17,20.79,47,68,115
2011-02-18 00:00:00,4,2,21.72,45.62,41.07,29,125,154
2011-02-18 01:00:00,2,4,11.21,54.76,36.48,0,129,129
2011-02-18 02:00:00,4,4,23.71,33.54,27.03,26,195,221
2011-02-18 03:00:00,1,1,15.73,59.7,43.85,47,43,90
2011-02-18 04:00:00,2,1,30.33,73.06,41.44,48,127,175
2011-02-18 05:00:00,1,2,18.6,59.79,26.59,5,37,42
2011-02-18 06:00:00,4,3,26.79,73.26,3.42,42,187,229
2011-02-18 07:00:00,4,1,7.87,25.32,28.3,6,154,160
2011-02-18 08:00:00,4,2,16.88,90.08,17.76,47,90,137
2011-02-18 09:00:00,1,4,34.5,95.13,27.01,21,125,146
2011-02-18 10:00:00,2,4,29.25,69.43,32.36,33,14,47
2011-02-18 11:00:00,2,2,9.8,90.51,32.24,19,166,185
2011-02-18 12:00:00,1,4,13.33,30.52,33.68,44,165,209
2011-02-18 13:00:00,2,4,14.89,83.8,33.96,44,181,225
2011-02-18 14:00:00,1,3,24.51,29.53,5.46,14,62,76
2011-02-18 15:00:00,2,4,27.71,52.64,9.59,46,185,231
2011-02-18 16:00:00,3,1,27.49,45.91,31.53,8,61,69
2011-02-18 17:00:00,3,4,20.3,66.85,20.41,17,77,94
2011-02-18 18:00:00,4,2,29.32,44.12,38.14,45,17,62
2011-02-18 19:00:00,3,3,18.11,70.99,6.25,45,156,201
2011-02-18 20:00:00,3,4,8.72,49.39,9.58,35,70,105
2011-02-18 21:00:00,3,2,21.93,88.86,27.92,45,184,229
2011-02-18 22:00:00,1,1,33.57,70.71,25.04,41,23,64
2011-02-18 23:00:00,3,4,28.79,37.22,13.32,29,37,66
2011-02-19 00:00:00,3,3,22.36,46.89,20.42,10,133,143
2011-02-19 01:00:00,4,4,24.4,87.79,1.75,32,147,179
2011-02-19 02:00:00,3,2,32.92,50.92,1.85,45,169,214
2011-02-19 03:00:00,3,3,17.85,62.86,4.75,39,21,60
2011-02-19 04:00:00,2,4,14.94,71.92,28.84,5,160,165
2011-02-19 05:00:00,4,1,34.32,47.82,43.19,42,45,87
2011-02-19 06:00:00,4,3,30.9,43.52,13.01,45,181,226
2011-02-19 07:00:00,4,1,14.69,58.02,1.7,38,104,142
2011-02-19 08:00:00,4,2,18.91,37.19,35.43,21,169,190
2011-02-19 09:00:00,4,4,17.45,42.74,42.77,38,178,216
2011-02-19 10:00:00,4,1,9.47,24.97,6.91,18,195,213
2011-02-19 11:00:00,1,2,33.73,44.32,19.29,21,84,105
2011-02-19 12:00:00,3,4,17.13,45.66,7.94,30,55,85
2011-02-19 13:00:00,4,2,31.26,96.95,5.32,41,76,117
2011-02-19 14:00:00,3,1,10.68,67.18,32.41,24,41,65
2011-02-19 15:00:00,3,2,21.44,82.99,48.38,40,12,52
2011-02-19 16:00:00,1,3,5.72,23.63,33.91,49,53,102
2011-02-19 17:00:00,4,4,27.93,28.52,49.24,48,139,187
2011-02-19 18:00:00,2,2,22.43,85.16,21.72,29,34,63
2011-02-19 19:00:00,1,1,23.77,69.88,44.89,44,82,126
2011-02-19 20:00:00,2,4,6.55,35.28,10.25,3,8,11
2011-02-19 21:00:00,3,3,11.33,52.38,5.9,25,12,37
2011-02-19 22:00:00,3,4,7.23,63.09,35.13,6,21,27
2011-02-19 23:00:00,1,3,13.67,87.49,18.57,39,39,78
2011-02-20 00:00:00,1,4,23.82,24.83,15.88,47,163,210
2011-02-20 01:00:00,2,2,21.99,67.74,33.56,11,116,127
2011-02-20 02:00:00,4,2,23.36,77.36,16.67,0,126,126
2011-02-20 03:00:00,2,1,21.48,98.23,28.63,5,168,173
2011-02-20 04:00:00,1,3,13.19,84.57,14.97,0,6,6
2011-02-20 05:00:00,2,1,12.34,42.1,39.19,7,54,61
2011-02-20 06:00:00,1,2,9.11,76.77,15.62,43,120,163
2011-02-20 07:00:00,2,3,30.47,81.06,26.75,47,78,125
2011-02-20 08:00:00,1,1,23.49,78.38,1.16,32,140,172
2011-02-20 09:00:00,1,1,10.6,85.61,39.59,3,98,101
2011-02-20 10:00:00,1,1,10.32,92.3,31.02,49,147,196
2011-02-20 11:00:00,4,1,31.19,27.87,9.61,39,185,224
2011-02-20 12:00:00,2,1,27.28,28.38,10.77,5,22,27
2011-02-20 13:00:00,2,3,24.78,83.71,13.12,44,180,224
2011-02-20 14:00:00,2,1,17.21,40.19,28.83,2,36,38
2011-02-20 15:00:00,1,3,12.86,24.68,27.42,14,19,33
2011-02-20 16:00:00,2,1,34.38,52.1,13.69,5,119,124
2011-02-20 17:00:00,2,2,28.92,85.59,34.7,5,146,151
2011-02-20 18:00:00,1,2,14.05,30.13,44.45,36,145,181
2011-02-20 19:00:00,3,1,30.43,73.75,2.18,26,67,93
2011-02-20 20:00:00,1,4,27.77,20.29,20.86,41,188,229
2011-02-20 21:00:00,2,2,13.91,28.78,29.68,40,199,239
2011-02-20 22:00:00,1,3,17.8,48.07,29.32,45,45,90
2011-02-20 23:00:00,3,1,10.58,26.69,0.98,4,175,179
2011-02-21 00:00:00,1,3,8.33,87.67,10.53,38,19,57
2011-02-21 01:00:00,2,4,26.68,89.13,3.09,16,71,87
2011-02-21 02:00:00,3,1,13.03,80.45,28.45,22,196,218
2011-02-21 03:00:00,4,2,29.6,39.4,32.27,16,104,120
2011-02-21 04:00:00,2,3,34.87,61.86,7.99,40,161,201
2011-02-21 05:00:00,3,2,7.3,34.74,16.65,22,103,125
2011-02-21 06:00:00,3,2,19.19,42.5,16.49,38,6,44
2011-02-21 07:00:00,4,1,29.06,61.28,40.99,32,49,81
2011-02-21 08:00:00,1,3,28.67,78.8,9.73,1,52,53
2011-02-21 09:00:00,1,4,27.8,27.57,27.42,9,72,81
2011-02-21 10:00:00,2,2,15.47,43.74,39.15,18,10,28
2011-02-21 11:00:00,4,1,18.62,94.13,41.48,39,135,174
2011-02-21 12:00:00,1,1,22.85,54.33,33.33,8,31,39
2011-02-21 13:00:00,4,4,34.22,95.11,14.98,14,190,204
2011-02-21 14:00:00,1,1,14.83,99.31,41.15,42,182,224
2011-02-21 15:00:00,3,2,32.69,62.13,37.11,23,186,209
2011-02-21 16:00:00,1,1,13.08,43.04,35.22,11,62,73
2011-02-21 17:00:00,4,3,34.67,83.26,3.37,21,144,165
2011-02-21 18:00:00,3,3,25.11,32.74,2.16,17,153,170
2011-02-21 19:00:00,3,2,18.91,40.16,34.77,1,50,51
2011-02-21 20:00:00,3,3,23.4,82.79,47.24,14,32,46
2011-02-21 21:00:00,4,4,13.18,54.69,38.69,41,25,66
2011-02-21 22:00:00,2,1,13.23,36.12,41.57,38,21,59
2011-02-21 23:00:00,2,2,8.41,72.09,27.25,8,194,202
2011-02-22 00:00:00,2,4,8.42,78.62,15.23,21,94,115
2011-02-22 01:00:00,4,1,15.43,30.01,33.89,16,77,93
2011-02-22 02:00:00,3,4,27.89,42.16,35.6,13,103,116
2011-02-22 03:00:00,2,2,23.24,37.7,33.77,30,190,220
2011-02-22 04:00:00,4,2,8.08,50.39,47.34,40,144,184
2011-02-22 05:00:00,2,4,30.57,81.08,18.36,6,40,46
2011-02-22 06:00:00,1,1,23.04,77.1,1.98,46,75,121
2011-02-22 07:00:00,2,3,33.83,73.0,45.42,34,38,72
2011-02-22 08:00:00,2,3,25.11,20.5,8.02,33,160,193
2011-02-22 09:00:00,3,4,10.26,31.37,34.87,2,31,33
2011-02-22 10:00:00,4,2,19.21,37.86,43.66,1,148,149
2011-02-22 11:00:00,3,1,24.45,41.76,15.51,44,180,224
2011-02-22 12:00:00,3,1,5.85,31.71,41.52,26,191,217
2011-02-22 13:00:00,3,2,5.45,52.83,16.6,44,77,121
2011-02-22 14:00:00,3,3,8.88,26.01,39.71,1,65,66
2011-02-22 15:00:00,3,1,12.55,80.0,3.49,40,176,216
2011-02-22 16:00:00,2,4,17.89,83.02,32.76,4,70,74
2011-02-22 17:00:00,3,3,19.62,65.94,33.86,20,30,50
2011-02-22 18:00:00,3,4,9.14,27.18,24.57,6,91,97
2011-02-22 19:00:00,4,3,25.2,91.21,34.35,24,168,192
2011-02-22 20:00:00,1,2,22.88,97.25,46.16,44,199,243
2011-02-22 21:00:00,2,4,13.83,36.19,36.69,0,198,198
2011-02-22 22:00:00,2,4,5.41,76.37,48.06,8,163,171
2011-02-22 23:00:00,2,2,7.33,87.36,22.43,1,73,74
2011-02-23 00:00:00,3,4,16.75,63.19,26.41,2,166,168
2011-02-23 01:00:00,3,3,9.62,45.87,13.19,43,110,153
2011-02-23 02:00:00,3,1,16.3,58.28,49.28,36,125,161
2011-02-23 03:00:00,4,1,23.85,60.98,2.76,43,93,136
2011-02-23 04:00:00,1,2,21.42,52.05,17.93,3,108,111
2011-02-23 05:00:00,3,3,11.94,94.39,14.88,20,103,123
2011-02-23 06:00:00,1,4,15.31,79.51,19.33,25,168,193
2011-02-23 07:00:00,4,4,23.42,39.3,45.89,43,40,83
2011-02-23 08:00:00,2,1,30.83,66.84,18.4,36,4,40
2011-02-23 09:00:00,3,4,27.6,75.1,45.85,13,5,18
2011-02-23 10:00:00,1,1,21.6,31.21,21.17,45,61,106
2011-02-23 11:00:00,1,2,15.87,48.67,42.74,9,15,24
2011-02-23 12:00:00,3,4,15.95,92.44,26.09,25,87,112
2011-02-23 13:00:00,2,3,31.38,65.37,15.57,9,109,118
2011-02-23 14:00:00,2,4,6.18,37.36,22.47,36,146,182
2011-02-23 15:00:00,2,1,34.64,29.82,21.22,17,82,99
2011-02-23 16:00:00,4,2,24.93,61.46,13.0,26,122,148
2011-02-23 17:00:00,1,1,25.43,63.81,14.48,16,164,180
2011-02-23 18:00:00,1,4,6.14,46.75,9.32,9,63,72
2011-02-23 19:00:00,1,1,23.17,70.43,16.8,10,186,196
2011-02-23 20:00:00,4,1,19.54,25.49,31.22,46,96,142
2011-02-23 21:00:00,1,2,8.17,31.61,19.33,23,68,91
2011-02-23 22:00:00,4,3,13.34,63.7,35.62,18,134,152
2011-02-23 23:00:00,2,4,31.71,24.95,49.35,43,41,84
2011-02-24 00:00:00,3,2,21.5,90.47,18.86,15,152,167
2011-02-24 01:00:00,1,3,17.4,31.37,23.13,22,55,77
2011-02-24 02:00:00,1,1,7.18,73.91,8.21,11,174,185
2011-02-24 03:00:00,2,3,26.42,51.3,19.61,18,84,102
2011-02-24 04:00:00,3,1,26.09,51.98,36.34,24,107,131
2011-02-24 05:00:00,4,1,23.42,81.19,10.87,2,177,179
2011-02-24 06:00:00,3,2,20.31,59.96,9.1,12,84,96
2011-02-24 07:00:00,2,1,18.01,78.05,18.82,20,90,110
2011-02-24 08:00:00,2,2,22.8,60.42,40.93,21,32,53
2011-02-24 09:00:00,3,3,12.0,67.43,31.18,46,25,71
2011-02-24 10:00:00,4,3,33.24,80.86,47.88,28,16,44
2011-02-24 11:00:00,4,1,22.66,68.58,45.23,48,20,68
2011-02-24 12:00:00,1,2,14.34,69.25,7.56,42,1,43
2011-02-24 13:00:00,4,1,18.49,83.14,2.13,24,78,102
2011-02-24 14:00:00,3,2,29.17,95.93,19.95,22,43,65
2011-02-24 15:00:00,2,2,9.85,50.14,26.1,11,193,204
2011-02-24 16:00:00,1,2,13.79,66.17,25.78,48,70,118
2011-02-24 17:00:00,1,3,25.39,26.9,6.71,22,35,57
2011-02-24 18:00:00,2,2,14.46,48.7,6.24,4,45,49
2011-02-24 19:00:00,4,3,28.78,52.96,2.34,28,177,205
2011-02-24 20:00:00,2,2,8.91,86.82,42.54,4,66,70
2011-02-24 21:00:00,4,3,27.88,61.07,47.39,38,2,40
2011-02-24 22:00:00,2,4,7.05,78.49,5.78,34,118,152
2011-02-24 23:00:00,3,3,5.38,21.52,10.66,34,160,194
2011-02-25 00:00:00,4,3,31.95,57.16,4.49,16,44,60
2011-02-25 01:00:00,3,1,22.44,92.11,43.88,29,24,53
2011-02-25 02:00:00,1,2,15.55,37.95,47.94,1,164,165
2011-02-25 03:00:00,2,4,11.98,22.52,13.09,14,163,177
2011-02-25 04:00:00,1,1,23.51,54.67,15.18,22,34,56
2011-02-25 05:00:00,1,2,20.27,76.35,18.13,41,18,59
2011-02-25 06:00:00,1,4,34.75,56.36,25.12,25,44,69
2011-02-25 07:00:00,1,4,34.5,56.8,34.12,10,111,121
2011-02-25 08:00:00,2,4,24.05,73.58,25.22,23,145,168
2011-02-25 09:00:00,1,2,18.29,40.35,47.55,8,154,162
2011-02-25 10:00:00,2,4,19.73,80.15,4.99,13,93,106
2011-02-25 11:00:00,2,4,25.47,32.25,39.93,23,30,53
2011-02-25 12:00:00,3,1,8.05,51.66,16.72,6,166,172
2011-02-25 13:00:00,4,3,14.85,72.48,18.88,9,66,75
2011-02-25 14:00:00,4,2,7.26,86.27,35.44,32,149,181
2011-02-25 15:00:00,2,3,7.2,83.32,46.47,32,179,211
2011-02-25 16:00:00,3,1,10.88,77.73,35.81,45,9,54
2011-02-25 17:00:00,2,3,19.56,48.73,38.79,26,116,142
2011-02-25 18:00:00,2,4,28.54,29.78,37.54,7,7,14
2011-02-25 19:00:00,2,4,19.56,37.35,16.05,13,33,46
2011-02-25 20:00:00,3,2,15.06,89.19,37.85,6,180,186
2011-02-25 21:00:00,4,2,7.47,88.59,39.23,17,145,162
2011-02-25 22:00:00,3,2,21.51,96.12,26.67,25,11,36
2011-02-25 23:00:00,1,1,13.14,26.08,26.84,40,191,231
2011-02-26 00:00:00,3,2,23.45,62.94,37.99,14,184,198
2011-02-26 01:00:00,3,1,34.32,71.89,40.85,32,95,127
2011-02-26 02:00:00,3,4,8.34,76.85,16.86,10,129,139
2011-02-26 03:00:00,3,3,11.36,71.51,40.08,18,16,34
2011-02-26 04:00:00,4,4,19.19,81.6,40.71,41,179,220
2011-02-26 05:00:00,1,4,34.06,48.76,11.71,17,75,92
2011-02-26 06:00:00,4,4,28.15,34.35,35.85,21,70,91
2011-02-26 07:00:00,4,2,31.95,36.37,9.33,35,78,113
2011-02-26 08:00:00,3,2,15.01,20.96,4.65,17,1,18
2011-02-26 09:00:00,2,2,34.76,48.03,28.73,17,26,43
2011-02-26 10:00:00,2,3,8.08,27.34,45.43,21,153,174
2011-02-26 11:00:00,4,2,6.59,45.72,1.77,24,152,176
2011-02-26 12:00:00,4,1,30.67,70.26,41.33,43,139,182
2011-02-26 13:00:00,3,4,32.82,91.56,25.32,30,144,174
2011-02-26 14:00:00,4,3,7.72,87.17,43.04,8,192,200
2011-02-26 15:00:00,3,3,8.4,40.21,42.17,49,94,143
2011-02-26 16:00:00,2,3,6.0,30.73,43.76,37,167,204
2011-02-26 17:00:00,2,3,8.14,35.45,38.44,18,4,22
2011-02-26 18:00:00,1,3,11.28,97.68,42.15,24,27,51
2011-02-26 19:00:00,2,1,34.1,63.96,8.8,14,71,85
2011-02-26 20:00:00,4,4,25.04,34.6,15.19,4,51,55
2011-02-26 21:00:00,2,3,28.36,87.26,12.12,10,141,151
2011-02-26 22:00:00,3,4,28.28,51.62,37.12,12,133,145
2011-02-26 23:00:00,2,2,21.05,91.94,7.68,33,17,50
2011-02-27 00:00:00,1,3,28.92,40.85,9.11,7,36,43
2011-02-27 01:00:00,2,3,22.87,51.46,43.95,24,191,215
2011-02-27 02:00:00,3,4,14.44,60.4,35.29,26,98,124
2011-02-27 03:00:00,3,3,21.83,91.41,43.77,10,34,44
2011-02-27 04:00:00,4,3,21.01,89.5,6.97,17,125,142
2011-02-27 05:00:00,2,3,29.7,65.95,19.95,9,16,25
2011-02-27 06:00:00,3,1,34.45,37.74,14.16,32,109,141
2011-02-27 07:00:00,1,1,17.33,52.27,0.48,35,87,122
2011-02-27 08:00:00,4,3,27.9,98.05,14.23,16,9,25
2011-02-27 09:00:00,1,1,7.99,68.62,18.98,48,50,98
2011-02-27 10:00:00,2,2,28.3,82.49,4.61,4,111,115
2011-02-27 11:00:00,2,3,16.14,55.99,28.32,22,80,102
2011-02-27 12:00:00,2,2,6.18,62.56,19.16,2,51,53
2011-02-27 13:00:00,4,4,15.9,54.32,2.32,38,63,101
2011-02-27 14:00:00,3,2,23.32,76.23,35.2,36,32,68
2011-02-27 15:00:00,4,4,8.58,88.12,36.46,9,96,105
2011-02-27 16:00:00,1,3,32.72,60.59,41.72,26,16,42
2011-02-27 17:00:00,4,4,7.33,58.47,24.28,6,123,129
2011-02-27 18:00:00,1,4,32.9,47.22,48.43,48,176,224
2011-02-27 19:00:00,4,2,26.21,34.17,45.7,28,107,135
2011-02-27 20:00:00,3,2,14.89,95.14,27.57,48,126,174
2011-02-27 21:00:00,1,2,16.72,45.29,22.25,38,6,44
2011-02-27 22:00:00,2,3,27.22,84.06,0.15,5,111,116
2011-02-27 23:00:00,2,3,23.04,77.23,35.55,8,192,200
2011-02-28 00:00:00,4,2,25.15,83.27,28.25,7,126,133
2011-02-28 01:00:00,2,3,16.67,94.94,46.88,13,189,202
2011-02-28 02:00:00,1,3,19.63,69.87,29.71,37,9,46
2011-02-28 03:00:00,2,4,34.7,91.84,49.64,8,30,38
2011-02-28 04:00:00,3,4,11.42,33.42,42.69,10,24,34
2011-02-28 05:00:00,3,2,17.54,70.14,47.68,10,184,194
2011-02-28 06:00:00,4,3,13.75,81.78,16.38,39,64,103
2011-02-28 07:00:00,1,4,27.95,41.73,7.47,34,170,204
2011-02-28 08:00:00,3,1,27.92,79.26,39.84,10,130,140
2011-02-28 09:00:00,3,3,13.77,82.28,39.31,35,54,89
2011-02-28 10:00:00,1,1,7.44,86.5,10.57,2,47,49
2011-02-28 11:00:00,2,2,5.34,45.03,38.24,44,64,108
2011-02-28 12:00:00,2,3,17.82,74.53,29.1,18,198,216
2011-02-28 13:00:00,4,2,17.31,44.34,5.48,7,112,119
2011-02-28 14:00:00,2,2,34.65,79.12,25.09,27,114,141
2011-02-28 15:00:00,1,2,19.09,57.04,46.56,0,59,59
2011-02-28 16:00:00,3,2,12.69,67.8,25.32,39,13,52
2011-02-28 17:00:00,2,2,31.74,53.27,39.43,29,86,115
2011-02-28 18:00:00,4,3,19.73,32.96,1.45,40,80,120
2011-02-28 19:00:00,2,1,22.98,34.24,36.4,37,13,50
2011-02-28 20:00:00,1,3,7.87,26.21,47.34,10,136,146
2011-02-28 21:00:00,4,3,16.49,69.45,24.98,28,84,112
2011-02-28 22:00:00,2,3,33.33,87.89,16.89,30,172,202
2011-02-28 23:00:00,4,4,22.69,21.67,32.33,9,1,10
2011-03-01 00:00:00,1,4,15.34,25.3,45.81,34,159,193
2011-03-01 01:00:00,3,3,23.77,56.6,8.84,39,7,46
2011-03-01 02:00:00,1,1,32.31,79.02,20.18,28,35,63
2011-03-01 03:00:00,1,3,13.22,32.62,7.81,36,164,200
2011-03-01 04:00:00,1,2,20.15,41.73,24.83,1,14,15
2011-03-01 05:00:00,1,4,33.76,38.56,27.02,47,33,80
2011-03-01 06:00:00,3,4,10.17,51.92,47.21,0,148,148
2011-03-01 07:00:00,3,3,26.59,38.0,20.63,31,8,39
2011-03-01 08:00:00,4,3,23.43,48.21,28.35,23,39,62
2011-03-01 09:00:00,2,1,25.39,78.28,44.26,1,25,26
2011-03-01 10:00:00,3,1,15.54,68.88,16.07,2,149,151
2011-03-01 11:00:00,3,2,14.42,26.49,33.71,8,140,148
2011-03-01 12:00:00,2,3,25.53,71.02,37.86,48,24,72
2011-03-01 13:00:00,3,3,11.47,58.17,16.53,23,198,221
2011-03-01 14:00:00,1,3,17.59,94.77,8.22,11,114,125
2011-03-01 15:00:00,1,4,10.65,43.14,25.15,33,90,123
2011-03-01 16:00:00,2,2,5.25,78.09,17.84,33,142,175
2011-03-01 17:00:00,4,1,34.1,78.47,13.32,22,44,66
2011-03-01 18:00:00,4,4,17.95,37.72,48.67,18,20,38
2011-03-01 19:00:00,2,4,34.08,92.26,25.11,31,88,119
2011-03-01 20:00:00,2,4,9.21,59.29,42.82,48,39,87
2011-03-01 21:00:00,1,4,22.62,74.31,9.77,27,174,201
2011-03-01 22:00:00,4,2,11.03,31.67,46.97,25,85,110
2011-03-01 23:00:00,3,3,28.7,40.62,39.72,48,60,108
2011-03-02 00:00:00,1,1,28.51,66.89,40.43,44,13,57
2011-03-02 01:00:00,2,1,8.38,45.52,19.49,11,199,210
2011-03-02 02:00:00,4,4,32.36,59.98,24.28,42,87,129
2011-03-02 03:00:00,3,4,10.84,49.92,29.67,30,66,96
2011-03-02 04:00:00,3,2,23.39,71.24,39.49,10,75,85
2011-03-02 05:00:00,1,4,34.57,58.97,42.45,39,174,213
2011-03-02 06:00:00,4,1,31.47,20.37,3.9,49,143,192
2011-03-02 07:00:00,4,1,33.7,71.97,45.2,3,70,73
2011-03-02 08:00:00,2,3,15.28,53.77,46.87,17,17,34
2011-03-02 09:00:00,4,3,8.17,47.34,29.64,28,172,200
2011-03-02 10:00:00,4,1,10.65,27.53,9.34,46,22,68
2011-03-02 11:00:00,1,1,20.01,37.63,40.92,38,25,63
2011-03-02 12:00:00,4,2,28.8,37.9,27.43,46,193,239
2011-03-02 13:00:00,3,2,9.5,94.83,40.86,30,129,159
2011-03-02 14:00:00,1,1,24.79,54.6,40.74,27,149,176
2011-03-02 15:00:00,1,4,14.71,23.37,4.34,26,114,140
2011-03-02 16:00:00,2,3,15.24,31.11,30.35,29,165,194
2011-03-02 17:00:00,4,1,24.86,26.32,24.16,48,169,217
2011-03-02 18:00:00,2,4,19.01,67.11,47.31,41,155,196
2011-03-02 19:00:00,3,1,29.36,34.93,14.83,10,62,72
2011-03-02 20:00:00,1,3,9.68,59.88,10.3,13,16,29
2011-03-02 21:00:00,1,3,28.7,49.6,44.85,3,111,114
2011-03-02 22:00:00,1,2,6.93,84.31,7.44,35,186,221
2011-03-02 23:00:00,3,2,10.82,45.64,34.33,0,114,114
2011-03-03 00:00:00,3,2,24.68,56.66,15.0,43,1,44
2011-03-03 01:00:00,2,2,30.65,77.7,28.39,38,98,136
2011-03-03 02:00:00,2,3,12.58,54.67,30.81,36,78,114
2011-03-03 03:00:00,2,4,14.82,83.46,20.87,32,107,139
2011-03-03 04:00:00,4,4,21.11,72.93,48.75,20,115,135
2011-03-03 05:00:00,1,4,11.35,52.84,6.59,23,108,131
2011-03-03 06:00:00,1,1,29.33,60.32,19.57,39,177,216
2011-03-03 07:00:00,2,2,28.21,97.38,21.52,49,142,191
2011-03-03 08:00:00,1,2,9.36,72.93,31.55,12,145,157
2011-03-03 09:00:00,2,3,18.91,92.4,20.36,48,76,124
2011-03-03 10:00:00,4,3,28.24,34.3,4.85,33,37,70
2011-03-03 11:00:00,4,1,15.12,58.66,47.37,37,135,172
2011-03-03 12:00:00,3,1,23.99,92.69,20.8,28,79,107
2011-03-03 13:00:00,4,4,6.51,45.81,17.13,35,147,182
2011-03-03 14:00:00,2,3,23.26,97.41,22.34,39,187,226
2011-03-03 15:00:00,4,2,9.58,27.77,10.83,46,25,71
2011-03-03 16:00:00,3,4,29.92,92.21,5.01,4,162,166
2011-03-03 17:00:00,1,2,15.66,55.62,7.43,19,120,139
2011-03-03 18:00:00,2,4,13.45,25.9,8.33,28,80,108
2011-03-03 19:00:00,1,2,30.23,90.36,9.88,10,153,163
2011-03-03 20:00:00,3,1,6.5,40.16,21.0,7,17,24
2011-03-03 21:00:00,3,4,16.9,21.78,31.19,27,171,198
2011-03-03 22:00:00,3,2,16.1,30.86,31.44,48,134,182
2011-03-03 23:00:00,1,2,13.54,72.73,0.0,40,34,74
2011-03-04 00:00:00,1,3,32.35,98.22,46.05,17,11,28
2011-03-04 01:00:00,1,4,27.53,28.92,41.14,29,120,149
2011-03-04 02:00:00,1,2,6.92,56.96,48.2,13,112,125
2011-03-04 03:00:00,3,3,26.44,34.45,18.0,8,43,51
2011-03-04 04:00:00,3,2,20.82,79.6,33.24,9,40,49
2011-03-04 05:00:00,2,4,32.03,29.44,8.4,24,53,77
2011-03-04 06:00:00,2,1,14.39,39.19,40.85,26,128,154
2011-03-04 07:00:00,1,4,22.22,35.71,8.07,1,24,25
2011-03-04 08:00:00,4,4,20.02,64.2,16.3,2,79,81
2011-03-04 09:00:00,4,2,19.69,89.85,24.54,28,121,149
2011-03-04 10:00:00,3,2,18.68,60.89,29.73,36,14,50
2011-03-04 11:00:00,3,4,11.17,24.66,27.98,26,74,100
2011-03-04 12:00:00,3,3,27.67,65.07,5.1,3,100,103
2011-03-04 13:00:00,2,3,18.54,83.8,21.08,34,130,164
2011-03-04 14:00:00,2,3,33.76,30.57,46.15,26,172,198
2011-03-04 15:00:00,3,2,12.82,25.82,43.62,18,119,137
2011-03-04 16:00:00,3,2,25.48,35.02,29.54,9,44,53
2011-03-04 17:00:00,3,4,33.22,79.69,28.62,25,178,203
2011-03-04 18:00:00,4,1,24.9,67.33,5.58,6,169,175
2011-03-04 19:00:00,2,2,31.14,63.25,10.01,26,166,192
2011-03-04 20:00:00,4,4,29.82,39.96,12.63,29,19,48
2011-03-04 21:00:00,4,4,15.8,46.58,24.41,11,145,156
2011-03-04 22:00:00,3,1,23.0,97.27,36.57,39,115,154
2011-03-04 23:00:00,3,3,9.69,39.25,23.04,4,166,170
2011-03-05 00:00:00,1,4,21.07,92.13,6.3,12,98,110
2011-03-05 01:00:00,1,4,11.91,66.44,21.97,40,28,68
2011-03-05 02:00:00,4,4,27.31,29.86,8.13,3,19,22
2011-03-05 03:00:00,2,3,20.84,57.38,37.56,1,169,170
2011-03-05 04:00:00,3,3,17.34,95.88,8.33,36,78,114
2011-03-05 05:00:00,3,1,13.06,53.49,24.13,33,95,128
2011-03-05 06:00:00,4,2,34.96,89.07,34.67,49,11,60
2011-03-05 07:00:00,1,3,7.15,40.51,11.41,5,55,60
2011-03-05 08:00:00,2,2,6.31,65.67,3.8,25,114,139
2011-03-05 09:00:00,1,2,11.52,87.51,28.16,10,11,21
2011-03-05 10:00:00,1,3,34.13,93.66,2.71,41,52,93
2011-03-05 11:00:00,1,4,34.38,58.87,29.39,0,97,97
2011-03-05 12:00:00,1,1,24.65,71.18,37.67,33,7,40
2011-03-05 13:00:00,3,2,31.4,20.24,16.47,20,57,77
2011-03-05 14:00:00,3,4,11.42,40.26,24.42,9,23,32
2011-03-05 15:00:00,1,3,34.16,42.3,46.44,4,108,112
2011-03-05 16:00:00,2,2,9.28,27.48,23.56,25,60,85
2011-03-05 17:00:00,4,2,8.03,42.38,49.83,43,128,171
2011-03-05 18:00:00,2,2,8.37,45.69,7.85,18,88,106
2011-03-05 19:00:00,2,4,22.19,97.5,35.45,20,77,97
2011-03-05 20:00:00,2,4,28.43,73.49,32.63,33,69,102
2011-03-05 21:00:00,1,4,16.0,54.08,43.62,28,172,200
2011-03-05 22:00:00,3,2,34.34,99.04,4.62,37,136,173
2011-03-05 23:00:00,2,2,18.03,32.26,14.01,14,111,125
2011-03-06 00:00:00,1,1,9.51,58.08,6.61,39,128,167
2011-03-06 01:00:00,2,1,18.98,71.76,46.65,15,151,166
2011-03-06 02:00:00,2,4,25.37,24.45,21.33,17,59,76
2011-03-06 03:00:00,1,4,29.97,77.36,45.5,48,175,223
2011-03-06 04:00:00,3,3,18.76,27.99,14.72,0,166,166
2011-03-06 05:00:00,3,4,22.81,31.22,6.32,10,17,27
2011-03-06 06:00:00,4,1,13.02,32.78,14.83,35,104,139
2011-03-06 07:00:00,1,1,24.38,94.31,29.86,31,91,122
2011-03-06 08:00:00,4,1,34.58,74.66,42.26,27,51,78
2011-03-06 09:00:00,4,2,6.47,72.43,19.27,5,1,6
2011-03-06 10:00:00,4,2,31.6,64.44,45.74,6,100,106
2011-03-06 11:00:00,3,4,21.87,43.42,12.21,39,163,202
2011-03-06 12:00:00,1,3,12.56,69.67,34.68,23,47,70
2011-03-06 13:00:00,4,3,33.65,52.81,36.79,9,116,125
2011-03-06 14:00:00,1,3,19.5,31.63,13.7,29,87,116
2011-03-06 15:00:00,1,2,14.95,75.17,1.35,16,34,50
2011-03-06 16:00:00,3,1,10.44,30.37,18.26,43,197,240
2011-03-06 17:00:00,4,1,12.33,35.25,2.26,7,80,87
2011-03-06 18:00:00,4,2,29.99,85.42,45.04,11,93,104
2011-03-06 19:00:00,1,3,23.43,72.81,47.68,25,114,139
2011-03-06 20:00:00,2,3,32.4,70.48,36.77,16,71,87
2011-03-06 21:00:00,3,4,11.96,53.46,36.33,34,169,203
2011-03-06 22:00:00,3,4,8.63,51.7,12.04,45,79,124
2011-03-06 23:00:00,3,3,5.18,75.22,3.7,43,37,80
2011-03-07 00:00:00,3,2,20.24,79.2,40.11,4,153,157
2011-03-07 01:00:00,4,3,34.95,60.82,27.96,44,30,74
2011-03-07 02:00:00,4,4,25.85,97.54,34.08,10,179,189
2011-03-07 03:00:00,2,3,14.25,96.46,38.98,15,187,202
2011-03-07 04:00:00,3,2,31.31,52.99,20.47,41,7,48
2011-03-07 05:00:00,3,1,28.45,85.65,7.23,29,188,217
2011-03-07 06:00:00,1,2,5.46,63.46,39.75,39,34,73
2011-03-07 07:00:00,4,2,29.51,60.94,22.69,5,33,38
2011-03-07 08:00:00,3,4,14.02,24.4,41.35,19,137,156
2011-03-07 09:00:00,2,2,9.49,65.92,21.88,19,167,186
2011-03-07 10:00:00,2,2,11.79,92.05,10.85,23,107,130
2011-03-07 11:00:00,4,4,19.06,82.41,8.55,26,51,77
2011-03-07 12:00:00,2,4,17.75,82.91,37.2,2,139,141
2011-03-07 13:00:00,2,1,13.67,32.79,28.74,23,104,127
2011-03-07 14:00:00,4,3,10.17,48.68,20.23,9,154,163
2011-03-07 15:00:00,3,2,27.87,38.66,24.61,24,146,170
2011-03-07 16:00:00,3,4,34.7,45.27,27.48,27,56,83
2011-03-07 17:00:00,2,1,28.33,66.36,11.97,17,53,70
2011-03-07 18:00:00,2,3,13.88,49.18,18.91,41,14,55
2011-03-07 19:00:00,3,4,12.34,64.86,14.62,44,109,153
2011-03-07 20:00:00,4,3,11.53,55.08,19.42,13,164,177
2011-03-07 21:00:00,2,3,9.1,42.93,25.03,0,188,188
2011-03-07 22:00:00,1,2,21.54,27.63,8.67,19,145,164
2011-03-07 23:00:00,4,2,23.16,91.35,19.68,46,43,89
2011-03-08 00:00:00,2,4,26.17,20.91,19.27,24,90,114
2011-03-08 01:00:00,2,3,25.41,20.13,14.3,11,101,112
2011-03-08 02:00:00,1,4,13.77,86.14,49.92,47,127,174
2011-03-08 03:00:00,1,4,14.91,99.74,3.68,38,83,121
2011-03-08 04:00:00,3,3,25.45,78.17,32.15,45,148,193
2011-03-08 05:00:00,4,4,15.48,21.22,8.72,8,28,36
2011-03-08 06:00:00,4,3,11.38,38.14,41.98,8,106,114
2011-03-08 07:00:00,3,3,16.23,97.75,45.71,41,14,55
2011-03-08 08:00:00,4,3,13.16,84.69,20.07,40,85,125
2011-03-08 09:00:00,4,3,7.65,65.34,41.17,24,86,110
2011-03-08 10:00:00,4,1,29.9,38.95,12.5,29,67,96
2011-03-08 11:00:00,4,3,30.59,21.15,7.0,47,87,134
2011-03-08 12:00:00,4,2,11.59,21.67,15.79,39,63,102
2011-03-08 13:00:00,1,2,6.94,68.96,17.08,27,13,40
2011-03-08 14:00:00,4,2,27.16,21.75,19.87,1,164,165
2011-03-08 15:00:00,1,3,11.35,99.49,18.65,24,53,77
2011-03-08 16:00:00,4,2,16.8,34.67,20.56,17,58,75
2011-03-08 17:00:00,3,1,6.92,76.86,35.5,23,127,150
2011-03-08 18:00:00,2,4,11.79,32.4,12.28,17,186,203
2011-03-08 19:00:00,1,3,28.79,63.21,0.93,26,54,80
2011-03-08 20:00:00,4,2,29.13,26.45,24.48,43,170,213
2011-03-08 21:00:00,3,1,11.21,81.34,22.41,34,179,213
2011-03-08 22:00:00,2,4,15.08,66.79,3.0,33,38,71
2011-03-08 23:00:00,1,1,9.03,26.89,6.69,37,76,113
2011-03-09 00:00:00,2,2,7.23,87.89,25.5,5,146,151
2011-03-09 01:00:00,3,1,34.77,63.76,11.74,48,183,231
2011-03-09 02:00:00,1,4,24.67,93.73,43.88,15,163,178
2011-03-09 03:00:00,2,2,21.26,93.33,8.66,22,179,201
2011-03-09 04:00:00,4,4,27.96,93.64,1.01,27,43,70
2011-03-09 05:00:00,1,1,30.2,26.22,22.38,12,45,57
2011-03-09 06:00:00,2,3,29.2,29.68,49.31,11,96,107
2011-03-09 07:00:00,3,3,5.5,99.02,31.69,10,167,177
2011-03-09 08:00:00,3,3,10.6,59.01,17.7,46,79,125
2011-03-09 09:00:00,1,3,24.65,39.06,0.84,48,180,228
2011-03-09 10:00:00,2,4,16.27,81.57,24.25,21,184,205
2011-03-09 11:00:00,1,3,34.47,41.14,10.32,30,146,176
2011-03-09 12:00:00,1,4,24.96,78.18,32.39,26,43,69
2011-03-09 13:00:00,2,2,33.7,86.98,29.15,26,93,119
2011-03-09 14:00:00,2,3,11.04,82.74,13.26,39,147,186
2011-03-09 15:00:00,4,4,30.92,41.92,3.44,25,43,68
2011-03-09 16:00:00,2,3,14.64,52.13,37.75,6,170,176
2011-03-09 17:00:00,3,3,34.69,53.06,29.27,10,110,120
2011-03-09 18:00:00,1,3,9.73,59.3,42.11,21,6,27
2011-03-09 19:00:00,1,4,20.49,33.39,12.99,39,41,80
2011-03-09 20:00:00,3,1,28.79,56.2,32.64,18,61,79
2011-03-09 21:00:00,2,3,17.98,60.86,5.93,37,1,38
2011-03-09 22:00:00,3,3,19.04,62.54,14.59,19,76,95
2011-03-09 23:00:00,3,2,34.59,85.59,32.83,18,45,63
2011-03-10 00:00:00,4,1,17.76,61.39,41.28,18,37,55
2011-03-10 01:00:00,3,4,23.12,38.46,16.05,35,94,129
2011-03-10 02:00:00,1,2,6.64,73.05,39.94,46,128,174
2011-03-10 03:00:00,3,3,30.27,83.79,33.89,26,174,200
2011-03-10 04:00:00,1,2,24.45,45.55,17.43,16,106,122
2011-03-10 05:00:00,1,2,17.12,71.62,43.82,17,140,157
2011-03-10 06:00:00,1,3,5.49,31.76,25.46,19,59,78
2011-03-10 07:00:00,2,1,22.75,47.35,32.41,43,191,234
2011-03-10 08:00:00,4,1,5.38,92.74,24.78,41,195,236
2011-03-10 09:00:00,1,2,5.04,92.9,22.64,40,54,94
2011-03-10 10:00:00,1,3,23.48,66.03,42.4,7,106,113
2011-03-10 11:00:00,2,4,10.67,76.19,14.74,39,30,69
2011-03-10 12:00:00,1,2,10.76,88.32,1.83,10,96,106
2011-03-10 13:00:00,3,4,24.6,96.68,43.99,29,141,170
2011-03-10 14:00:00,3,2,6.61,59.19,41.25,11,85,96
2011-03-10 15:00:00,4,2,14.4,64.93,18.33,22,132,154
2011-03-10 16:00:00,1,3,9.48,53.25,9.27,5,118,123
2011-03-10 17:00:00,2,3,22.41,25.76,33.78,34,181,215
2011-03-10 18:00:00,3,4,24.85,53.82,3.94,14,180,194
2011-03-10 19:00:00,2,4,26.63,83.25,21.19,37,164,201
2011-03-10 20:00:00,2,1,12.66,84.39,4.29,27,95,122
2011-03-10 21:00:00,3,3,7.68,91.39,29.9,6,184,190
2011-03-10 22:00:00,2,2,7.36,24.12,1.36,5,2,7
2011-03-10 23:00:00,3,2,17.78,62.17,31.46,26,138,164
2011-03-11 00:00:00,2,1,33.38,28.59,33.66,1,41,42
2011-03-11 01:00:00,3,3,11.53,36.06,24.36,5,182,187
2011-03-11 02:00:00,1,2,12.7,92.02,8.75,31,165,196
2011-03-11 03:00:00,4,1,8.03,59.74,5.07,28,151,179
2011-03-11 04:00:00,3,1,23.17,80.68,15.66,33,136,169
2011-03-11 05:00:00,3,2,25.4,25.15,23.26,0,140,140
2011-03-11 06:00:00,4,2,24.29,53.35,32.11,14,85,99
2011-03-11 07:00:00,3,4,30.83,73.94,0.06,9,145,154
2011-03-11 08:00:00,3,3,19.59,30.67,35.55,9,9,18
2011-03-11 09:00:00,2,4,9.03,46.07,35.64,9,139,148
2011-03-11 10:00:00,4,1,13.68,25.16,22.23,36,46,82
2011-03-11 11:00:00,1,2,24.87,72.11,17.17,31,82,113
2011-03-11 12:00:00,3,4,23.39,97.67,42.12,35,116,151
2011-03-11 13:00:00,4,1,20.93,86.16,39.23,24,9,33
2011-03-11 14:00:00,2,3,25.49,97.97,49.16,14,128,142
2011-03-11 15:00:00,1,2,24.12,87.65,18.6,8,184,192
2011-03-11 16:00:00,4,4,31.44,88.42,45.34,15,70,85
2011-03-11 17:00:00,1,3,22.58,66.17,4.37,40,118,158
2011-03-11 18:00:00,1,4,28.36,61.46,20.57,18,118,136
2011-03-11 19:00:00,1,1,12.46,52.5,23.27,45,138,183
2011-03-11 20:00:00,3,3,25.35,85.45,22.04,43,180,223
2011-03-11 21:00:00,3,4,32.07,34.57,31.25,11,126,137
2011-03-11 22:00:00,2,3,16.57,24.5,8.51,34,3,37
2011-03-11 23:00:00,2,1,28.37,95.83,43.32,42,188,230
2011-03-12 00:00:00,4,3,26.74,20.3,27.59,4,85,89
2011-03-12 01:00:00,2,4,6.79,98.15,45.21,37,9,46
2011-03-12 02:00:00,1,1,22.45,78.31,0.13,5,132,137
2011-03-12 03:00:00,1,2,8.91,46.28,31.5,13,188,201
2011-03-12 04:00:00,3,4,34.02,75.83,20.62,47,123,170
2011-03-12 05:00:00,1,4,29.34,85.43,25.25,11,75,86
2011-03-12 06:00:00,4,1,8.29,39.63,37.19,49,157,206
2011-03-12 07:00:00,1,1,8.65,81.67,11.36,21,56,77
2011-03-12 08:00:00,1,2,22.83,84.35,10.24,44,160,204
2011-03-12 09:00:00,4,4,15.35,39.95,35.15,40,164,204
2011-03-12 10:00:00,2,1,6.05,23.35,26.07,49,81,130
2011-03-12 11:00:00,2,2,21.25,36.33,11.68,3,195,198
2011-03-12 12:00:00,4,2,16.64,36.05,24.2,42,22,64
2011-03-12 13:00:00,3,1,8.03,25.22,22.98,17,69,86
2011-03-12 14:00:00,1,4,29.06,78.08,34.57,30,6,36
2011-03-12 15:00:00,4,3,32.45,50.4,0.13,34,18,52
2011-03-12 16:00:00,1,3,27.7,90.75,29.34,3,142,145
2011-03-12 17:00:00,3,2,29.67,40.17,30.28,8,116,124
2011-03-12 18:00:00,1,3,11.49,56.26,37.28,44,85,129
2011-03-12 19:00:00,4,3,12.91,71.12,44.46,14,159,173
2011-03-12 20:00:00,1,1,11.26,90.2,22.01,41,78,119
2011-03-12 21:00:00,2,2,27.95,61.97,17.13,20,58,78
2011-03-12 22:00:00,3,4,33.44,49.88,5.12,31,69,100
2011-03-12 23:00:00,3,2,26.51,89.36,16.84,8,197,205
2011-03-13 00:00:00,3,1,31.44,44.82,3.42,47,5,52
2011-03-13 01:00:00,4,3,24.16,26.35,40.14,31,75,106
2011-03-13 02:00:00,3,4,16.63,55.6,40.35,15,193,208
2011-03-13 03:00:00,2,2,17.77,82.81,20.86,44,131,175
2011-03-13 04:00:00,4,3,7.26,22.46,12.98,4,118,122
2011-03-13 05:00:00,2,2,5.94,66.87,5.9,41,69,110
2011-03-13 06:00:00,1,4,25.86,67.56,42.56,30,184,214
2011-03-13 07:00:00,1,2,18.15,94.28,43.87,24,188,212
2011-03-13 08:00:00,1,2,21.57,42.92,13.31,0,114,114
2011-03-13 09:00:00,1,2,21.73,42.31,31.09,2,183,185
2011-03-13 10:00:00,2,3,13.32,55.24,12.93,20,100,120
2011-03-13 11:00:00,4,4,19.28,48.55,11.26,27,141,168
2011-03-13 12:00:00,4,4,19.12,78.91,1.06,2,110,112
2011-03-13 13:00:00,3,3,16.65,71.34,28.86,41,82,123
2011-03-13 14:00:00,2,3,29.62,80.71,7.5,31,6,37
2011-03-13 15:00:00,1,3,18.53,85.6,0.62,31,181,212
2011-03-13 16:00:00,2,1,23.11,93.84,5.24,48,185,233
2011-03-13 17:00:00,3,2,31.87,54.47,15.69,29,60,89
2011-03-13 18:00:00,3,2,30.99,98.78,33.46,49,107,156
2011-03-13 19:00:00,2,4,31.71,37.25,10.13,12,71,83
2011-03-13 20:00:00,2,2,13.1,77.15,44.38,33,155,188
2011-03-13 21:00:00,2,1,6.05,62.72,14.42,47,182,229
2011-03-13 22:00:00,4,3,12.83,85.35,16.56,3,98,101
2011-03-13 23:00:00,1,4,13.36,58.14,10.9,17,52,69
2011-03-14 00:00:00,2,4,32.28,82.72,12.69,31,82,113
2011-03-14 01:00:00,2,2,24.48,94.41,3.71,13,171,184
2011-03-14 02:00:00,2,4,7.45,78.58,14.74,31,27,58
2011-03-14 03:00:00,3,3,9.06,82.09,42.98,5,45,50
2011-03-14 04:00:00,3,4,9.67,25.37,34.42,42,176,218
2011-03-14 05:00:00,4,3,23.91,36.4,43.76,16,122,138
2011-03-14 06:00:00,1,1,27.06,97.94,5.24,7,194,201
2011-03-14 07:00:00,4,1,30.79,75.45,22.78,34,154,188
2011-03-14 08:00:00,1,3,33.22,64.92,11.46,23,166,189
2011-03-14 09:00:00,3,2,11.05,49.36,36.06,2,83,85
2011-03-14 10:00:00,3,4,14.29,23.55,48.51,16,26,42
2011-03-14 11:00:00,3,2,12.21,49.53,40.77,35,34,69
2011-03-14 12:00:00,4,4,15.76,59.91,1.76,39,46,85
2011-03-14 13:00:00,2,1,32.44,36.92,15.83,16,51,67
2011-03-14 14:00:00,2,1,22.25,33.85,1.43,29,68,97
2011-03-14 15:00:00,3,1,27.15,60.67,2.01,24,193,217
2011-03-14 16:00:00,2,4,19.7,66.87,3.98,21,40,61
2011-03-14 17:00:00,2,1,5.87,39.19,13.82,36,49,85
2011-03-14 18:00:00,4,1,6.93,66.99,15.21,10,44,54
2011-03-14 19:00:00,1,1,21.14,92.03,20.02,11,19,30
2011-03-14 20:00:00,3,1,26.56,57.85,20.25,20,119,139
2011-03-14 21:00:00,3,2,11.46,88.59,38.57,14,198,212
2011-03-14 22:00:00,4,1,26.66,94.18,7.07,11,35,46
2011-03-14 23:00:00,4,1,29.32,27.39,7.89,21,199,220
2011-03-15 00:00:00,2,2,17.36,27.66,31.33,38,90,128
2011-03-15 01:00:00,3,2,27.39,58.08,28.59,34,69,103
2011-03-15 02:00:00,1,4,17.12,67.05,7.7,41,151,192
2011-03-15 03:00:00,4,3,25.35,54.07,42.61,15,163,178
2011-03-15 04:00:00,1,1,27.92,46.12,16.45,32,132,164
2011-03-15 05:00:00,1,1,34.76,71.28,18.35,42,147,189
2011-03-15 06:00:00,3,1,15.36,20.17,21.02,48,180,228
2011-03-15 07:00:00,3,4,17.33,97.45,16.14,13,104,117
2011-03-15 08:00:00,4,1,9.97,38.57,27.87,17,167,184
2011-03-15 09:00:00,3,3,11.12,93.37,19.43,43,97,140
2011-03-15 10:00:00,3,2,25.8,28.72,12.97,15,102,117
2011-03-15 11:00:00,3,4,32.51,39.05,45.22,39,123,162
2011-03-15 12:00:00,1,2,16.84,38.79,15.42,2,177,179
2011-03-15 13:00:00,4,1,10.4,99.69,34.92,42,73,115
2011-03-15 14:00:00,2,1,13.55,20.37,17.36,25,194,219
2011-03-15 15:00:00,1,1,18.65,71.17,21.76,14,162,176
2011-03-15 16:00:00,3,3,13.72,89.57,11.8,35,63,98
2011-03-15 17:00:00,1,3,12.01,73.78,37.62,26,164,190
2011-03-15 18:00:00,3,4,27.08,49.02,36.86,47,44,91
2011-03-15 19:00:00,3,2,5.24,96.66,1.11,16,37,53
2011-03-15 20:00:00,1,1,21.18,91.48,3.01,13,109,122
2011-03-15 21:00:00,4,1,28.81,54.72,46.12,1,100,101
2011-03-15 22:00:00,3,1,12.99,65.87,44.44,26,84,110
2011-03-15 23:00:00,4,1,23.1,97.4,25.3,46,154,200
2011-03-16 00:00:00,2,3,25.07,98.6,24.67,23,192,215
2011-03-16 01:00:00,3,2,24.65,55.99,40.62,39,72,111
2011-03-16 02:00:00,4,2,18.38,87.79,6.92,44,2,46
2011-03-16 03:00:00,4,4,15.4,44.16,32.68,34,58,92
2011-03-16 04:00:00,2,3,30.08,49.75,23.8,3,99,102
2011-03-16 05:00:00,4,1,27.75,33.19,37.17,25,29,54
2011-03-16 06:00:00,4,2,14.64,36.73,1.51,35,15,50
2011-03-16 07:00:00,2,2,8.09,72.55,29.64,3,28,31
2011-03-16 08:00:00,3,3,7.15,60.86,27.84,33,197,230
2011-03-16 09:00:00,4,4,7.83,38.49,42.04,12,99,111
2011-03-16 10:00:00,4,4,22.49,52.23,33.84,39,23,62
2011-03-16 11:00:00,4,1,6.55,49.85,44.01,40,6,46
2011-03-16 12:00:00,1,4,15.11,98.99,44.36,0,176,176
2011-03-16 13:00:00,2,2,27.6,88.29,20.41,0,190,190
2011-03-16 14:00:00,1,4,13.83,51.04,6.87,8,100,108
2011-03-16 15:00:00,2,1,27.9,93.11,31.51,10,45,55
2011-03-16 16:00:00,3,2,27.36,47.41,43.69,15,47,62
2011-03-16 17:00:00,3,4,12.37,73.43,3.75,28,101,129
2011-03-16 18:00:00,4,4,26.86,97.33,27.9,35,152,187
2011-03-16 19:00:00,2,3,27.43,51.22,5.75,14,42,56
2011-03-16 20:00:00,3,1,16.92,74.39,1.35,38,54,92
2011-03-16 21:00:00,2,4,11.31,43.67,33.98,1,161,162
2011-03-16 22:00:00,3,3,20.64,41.3,34.09,9,64,73
2011-03-16 23:00:00,1,2,32.64,65.93,30.03,48,155,203
2011-03-17 00:00:00,3,3,24.19,98.34,42.96,10,40,50
2011-03-17 01:00:00,1,3,10.19,56.25,4.04,29,156,185
2011-03-17 02:00:00,3,4,25.48,95.01,5.26,22,159,181
2011-03-17 03:00:00,4,4,17.82,93.15,43.23,21,196,217
2011-03-17 04:00:00,1,4,22.75,40.3,25.16,41,33,74
2011-03-17 05:00:00,3,3,27.02,52.15,13.65,35,58,93
2011-03-17 06:00:00,4,2,20.45,71.46,36.91,28,188,216
2011-03-17 07:00:00,1,1,29.42,61.44,44.72,44,179,223
2011-03-17 08:00:00,4,3,26.66,27.68,34.48,31,62,93
2011-03-17 09:00:00,2,4,23.45,99.5,39.6,32,153,185
2011-03-17 10:00:00,2,1,9.52,80.21,14.12,38,11,49
2011-03-17 11:00:00,1,2,30.08,55.02,14.44,8,21,29
2011-03-17 12:00:00,3,1,33.08,69.45,43.21,0,55,55
2011-03-17 13:00:00,1,4,9.11,27.01,30.74,17,5,22
2011-03-17 14:00:00,4,3,19.65,59.62,11.71,49,35,84
2011-03-17 15:00:00,3,3,12.77,94.47,26.21,47,125,172
2011-03-17 16:00:00,2,4,27.64,91.73,34.29,21,186,207
2011-03-17 17:00:00,3,3,26.65,46.99,10.93,47,58,105
2011-03-17 18:00:00,2,4,9.23,62.51,32.75,36,67,103
2011-03-17 19:00:00,3,3,31.31,75.79,2.11,13,51,64
2011-03-17 20:00:00,3,3,10.43,47.2,15.18,21,119,140
2011-03-17 21:00:00,3,3,28.92,25.19,33.7,32,195,227
2011-03-17 22:00:00,4,2,18.71,60.44,7.47,5,76,81
2011-03-17 23:00:00,4,2,14.85,68.13,11.11,26,79,105
2011-03-18 00:00:00,1,4,9.75,20.47,43.95,5,106,111
2011-03-18 01:00:00,1,2,10.03,27.65,33.72,43,178,221
2011-03-18 02:00:00,2,4,24.86,36.58,24.95,49,89,138
2011-03-18 03:00:00,4,1,21.51,47.84,10.54,40,96,136
2011-03-18 04:00:00,2,1,8.66,63.28,17.07,15,67,82
2011-03-18 05:00:00,1,2,8.38,43.51,28.72,46,153,199
2011-03-18 06:00:00,2,1,7.17,42.09,7.77,1,72,73
2011-03-18 07:00:00,1,1,27.31,89.55,24.09,36,40,76
2011-03-18 08:00:00,4,3,26.36,31.6,20.45,28,132,160
2011-03-18 09:00:00,3,3,6.75,59.64,23.83,22,180,202
2011-03-18 10:00:00,4,4,21.81,96.23,5.28,20,165,185
2011-03-18 11:00:00,2,1,7.54,70.0,5.32,12,115,127
2011-03-18 12:00:00,2,4,32.11,77.38,48.21,0,92,92
2011-03-18 13:00:00,4,4,32.21,54.5,48.97,28,101,129
2011-03-18 14:00:00,4,1,25.95,21.59,21.31,47,103,150
2011-03-18 15:00:00,1,2,32.79,71.69,39.45,6,91,97
2011-03-18 16:00:00,2,1,29.34,70.55,32.79,30,180,210
2011-03-18 17:00:00,2,3,29.86,28.83,5.85,44,183,227
2011-03-18 18:00:00,4,1,22.09,56.97,14.83,21,18,39
2011-03-18 19:00:00,3,2,14.18,93.23,15.68,15,117,132
2011-03-18 20:00:00,2,4,11.53,36.41,29.79,27,64,91
2011-03-18 21:00:00,3,4,14.82,56.89,29.0,43,68,111
2011-03-18 22:00:00,4,3,23.85,56.89,46.18,38,52,90
2011-03-18 23:00:00,4,3,10.18,84.86,39.5,24,146,170
2011-03-19 00:00:00,1,3,12.76,85.97,42.84,13,65,78
2011-03-19 01:00:00,2,4,19.04,80.74,44.56,49,175,224
2011-03-19 02:00:00,3,3,11.99,49.24,40.06,20,65,85
2011-03-19 03:00:00,1,1,22.66,25.76,16.64,18,17,35
2011-03-19 04:00:00,2,4,32.7,47.96,10.75,12,79,91
2011-03-19 05:00:00,1,2,27.44,74.38,28.59,1,38,39
2011-03-19 06:00:00,4,4,24.99,76.22,34.48,35,126,161
2011-03-19 07:00:00,2,1,22.48,97.2,19.33,13,50,63
2011-03-19 08:00:00,1,1,19.64,56.29,42.42,33,126,159
2011-03-19 09:00:00,1,3,10.6,70.59,48.03,17,150,167
2011-03-19 10:00:00,3,4,31.84,63.14,28.47,23,160,183
2011-03-19 11:00:00,1,4,12.46,32.05,22.83,29,187,216
2011-03-19 12:00:00,2,4,7.74,56.9,42.14,18,186,204
2011-03-19 13:00:00,2,2,27.5,63.59,1.21,35,97,132
2011-03-19 14:00:00,3,3,10.27,96.06,6.45,20,153,173
2011-03-19 15:00:00,2,1,16.16,49.32,42.28,18,144,162
2011-03-19 16:00:00,4,1,5.85,98.41,36.6,25,180,205
2011-03-19 17:00:00,2,3,9.11,63.38,20.81,34,77,111
2011-03-19 18:00:00,2,1,10.2,39.4,44.44,39,170,209
2011-03-19 19:00:00,1,1,6.63,35.33,17.57,3,47,50
2011-03-19 20:00:00,1,3,24.7,31.34,31.69,20,81,101
2011-03-19 21:00:00,2,1,30.11,56.23,31.72,2,147,149
2011-03-19 22:00:00,3,4,16.2,21.75,9.22,4,162,166
2011-03-19 23:00:00,1,2,31.24,55.6,14.24,42,32,74
2011-03-20 00:00:00,3,3,11.4,99.07,45.8,28,80,108
2011-03-20 01:00:00,2,2,14.76,73.61,9.17,18,98,116
2011-03-20 02:00:00,2,1,9.52,80.78,8.68,16,1,17
2011-03-20 03:00:00,4,1,23.62,29.52,23.98,33,161,194
2011-03-20 04:00:00,1,4,17.6,57.85,4.61,19,75,94
2011-03-20 05:00:00,2,3,23.4,42.9,44.73,27,89,116
2011-03-20 06:00:00,4,1,27.85,91.53,5.01,8,125,133
2011-03-20 07:00:00,1,3,21.37,34.5,30.83,2,159,161
2011-03-20 08:00:00,2,3,23.83,56.7,16.99,9,20,29
2011-03-20 09:00:00,2,3,33.06,67.04,40.21,20,4,24
2011-03-20 10:00:00,1,3,13.97,61.12,29.49,40,27,67
2011-03-20 11:00:00,1,3,15.77,86.42,19.42,3,86,89
2011-03-20 12:00:00,1,2,26.53,38.52,49.19,21,47,68
2011-03-20 13:00:00,2,4,23.34,50.19,3.31,6,95,101
2011-03-20 14:00:00,2,3,10.36,83.37,28.89,11,196,207
2011-03-20 15:00:00,4,2,16.28,62.25,49.48,10,98,108
2011-03-20 16:00:00,3,1,19.04,52.17,34.55,21,69,90
2011-03-20 17:00:00,1,3,17.58,22.36,36.99,28,82,110
2011-03-20 18:00:00,2,1,10.35,80.27,1.6,26,167,193
2011-03-20 19:00:00,2,3,32.73,97.77,1.07,46,5,51
2011-03-20 20:00:00,1,2,27.87,69.62,1.81,19,141,160
2011-03-20 21:00:00,3,2,19.44,88.52,49.59,13,118,131
2011-03-20 22:00:00,1,2,25.4,61.35,48.98,6,124,130
2011-03-20 23:00:00,3,4,31.92,38.53,16.73,14,66,80
2011-03-21 00:00:00,2,1,9.09,21.16,14.55,45,138,183
2011-03-21 01:00:00,3,4,12.51,72.27,7.3,27,166,193
2011-03-21 02:00:00,4,3,21.28,59.45,16.46,42,168,210
2011-03-21 03:00:00,2,1,28.97,82.57,18.51,9,23,32
2011-03-21 04:00:00,4,2,6.09,75.57,37.41,2,170,172
2011-03-21 05:00:00,1,1,34.52,99.04,43.31,11,108,119
2011-03-21 06:00:00,1,2,18.65,60.83,37.34,12,94,106
2011-03-21 07:00:00,1,4,15.78,54.17,32.32,38,153,191
2011-03-21 08:00:00,3,4,13.78,42.94,38.3,43,28,71
2011-03-21 09:00:00,2,2,10.23,58.15,36.92,33,1,34
2011-03-21 10:00:00,1,2,28.75,89.83,23.79,0,29,29
2011-03-21 11:00:00,1,3,33.66,23.4,16.79,37,110,147
2011-03-21 12:00:00,2,4,17.41,98.23,14.14,24,73,97
2011-03-21 13:00:00,1,4,33.57,99.46,33.97,18,75,93
2011-03-21 14:00:00,4,3,29.71,67.83,47.97,24,184,208
2011-03-21 15:00:00,2,4,19.43,46.52,29.05,5,117,122
2011-03-21 16:00:00,2,2,25.22,37.84,45.63,44,186,230
2011-03-21 17:00:00,2,1,18.05,42.12,0.71,3,18,21
2011-03-21 18:00:00,4,1,21.76,24.01,39.72,25,53,78
2011-03-21 19:00:00,2,4,6.74,58.01,42.68,25,197,222
2011-03-21 20:00:00,4,3,25.89,24.59,31.55,25,119,144
2011-03-21 21:00:00,2,2,6.58,77.48,46.7,13,150,163
2011-03-21 22:00:00,3,1,29.51,49.75,29.5,31,94,125
2011-03-21 23:00:00,1,2,29.75,35.95,12.03,47,32,79
2011-03-22 00:00:00,3,4,12.11,63.59,10.79,27,65,92
2011-03-22 01:00:00,1,4,14.71,97.9,27.79,1,138,139
2011-03-22 02:00:00,4,1,19.44,75.61,45.32,40,89,129
2011-03-22 03:00:00,3,4,22.9,59.34,3.62,44,145,189
2011-03-22 04:00:00,2,3,13.62,82.15,30.22,20,64,84
2011-03-22 05:00:00,1,4,22.77,79.0,38.49,45,159,204
2011-03-22 06:00:00,1,4,13.93,91.34,5.77,13,131,144
2011-03-22 07:00:00,3,4,6.66,36.37,5.84,36,85,121
2011-03-22 08:00:00,4,2,5.08,88.71,18.31,1,35,36
2011-03-22 09:00:00,3,2,8.03,44.08,13.69,4,184,188
2011-03-22 10:00:00,4,1,28.77,95.28,9.92,37,113,150
2011-03-22 11:00:00,4,1,33.84,42.49,9.93,1,160,161
2011-03-22 12:00:00,1,1,17.81,94.15,6.53,0,141,141
2011-03-22 13:00:00,3,4,20.38,97.1,30.54,47,175,222
2011-03-22 14:00:00,3,2,9.41,31.64,34.41,21,36,57
2011-03-22 15:00:00,4,3,21.53,97.96,35.15,40,132,172
2011-03-22 16:00:00,3,4,9.34,26.86,26.62,24,49,73
2011-03-22 17:00:00,2,4,23.34,37.49,47.65,45,188,233
2011-03-22 18:00:00,2,4,33.0,55.53,44.03,29,68,97
2011-03-22 19:00:00,3,3,10.87,99.49,47.88,8,100,108
2011-03-22 20:00:00,3,1,27.94,59.09,19.44,36,165,201
2011-03-22 21:00:00,4,3,5.71,64.03,43.89,46,173,219
2011-03-22 22:00:00,2,1,16.26,75.55,38.14,9,97,106
2011-03-22 23:00:00,2,3,8.32,97.46,17.0,14,142,156
2011-03-23 00:00:00,1,2,15.57,82.67,5.33,48,36,84
2011-03-23 01:00:00,4,4,10.21,37.93,34.13,2,26,28
2011-03-23 02:00:00,1,4,16.2,44.24,6.82,7,111,118
2011-03-23 03:00:00,2,4,17.53,27.81,14.69,24,0,24
2011-03-23 04:00:00,4,1,14.02,71.56,25.02,35,156,191
2011-03-23 05:00:00,3,3,24.7,34.46,33.99,42,124,166
2011-03-23 06:00:00,4,2,32.57,40.59,46.31,45,199,244
2011-03-23 07:00:00,3,3,17.02,91.05,29.66,49,134,183
2011-03-23 08:00:00,3,4,10.77,46.14,33.57,20,28,48
2011-03-23 09:00:00,4,2,13.12,65.33,15.5,33,158,191
2011-03-23 10:00:00,3,2,30.62,51.81,34.36,26,37,63
2011-03-23 11:00:00,1,4,22.15,25.92,21.89,8,7,15
2011-03-23 12:00:00,2,3,18.65,49.03,42.85,9,94,103
2011-03-23 13:00:00,3,4,9.49,52.65,19.62,26,164,190
2011-03-23 14:00:00,1,3,18.49,91.66,23.41,24,186,210
2011-03-23 15:00:00,3,2,13.35,45.96,21.63,12,181,193
2011-03-23 16:00:00,2,2,33.29,50.34,40.56,3,185,188
2011-03-23 17:00:00,1,4,31.52,82.63,47.68,15,95,110
2011-03-23 18:00:00,2,2,7.52,80.72,16.36,11,25,36
2011-03-23 19:00:00,2,1,20.5,83.86,23.75,24,175,199
2011-03-23 20:00:00,1,2,11.75,96.3,35.3,47,112,159
2011-03-23 21:00:00,1,1,17.32,83.64,44.77,48,10,58
2011-03-23 22:00:00,1,2,31.31,52.61,24.69,15,22,37
2011-03-23 23:00:00,4,4,20.83,85.72,5.44,38,161,199
2011-03-24 00:00:00,1,4,15.03,60.69,18.43,1,32,33
2011-03-24 01:00:00,1,1,11.24,42.22,27.52,8,129,137
2011-03-24 02:00:00,1,4,29.01,44.23,20.88,43,112,155
2011-03-24 03:00:00,1,2,23.74,37.91,9.33,12,60,72
2011-03-24 04:00:00,3,2,19.04,31.6,1.85,13,131,144
2011-03-24 05:00:00,4,4,11.52,34.76,34.37,11,11,22
2011-03-24 06:00:00,2,2,15.03,25.05,49.64,34,156,190
2011-03-24 07:00:00,1,3,33.8,91.08,45.96,21,106,127
2011-03-24 08:00:00,3,3,20.6,94.48,34.16,20,102,122
2011-03-24 09:00:00,3,2,17.02,66.94,42.08,47,169,216
2011-03-24 10:00:00,3,4,20.64,87.24,12.79,49,184,233
2011-03-24 11:00:00,2,1,28.37,34.69,31.12,2,177,179
2011-03-24 12:00:00,1,4,15.2,92.13,3.03,21,65,86
2011-03-24 13:00:00,4,1,10.36,60.51,35.36,8,134,142
2011-03-24 14:00:00,4,4,22.55,25.37,48.49,46,124,170
2011-03-24 15:00:00,3,2,24.96,31.31,43.04,39,56,95
2011-03-24 16:00:00,2,3,26.38,44.72,26.72,41,45,86
2011-03-24 17:00:00,2,4,31.46,23.48,39.44,2,21,23
2011-03-24 18:00:00,2,1,16.14,44.74,47.19,30,138,168
2011-03-24 19:00:00,4,3,7.26,24.79,10.8,36,160,196
2011-03-24 20:00:00,3,1,33.75,38.88,39.66,5,181,186
2011-03-24 21:00:00,1,2,18.05,41.25,13.49,13,147,160
2011-03-24 22:00:00,4,3,23.7,99.55,43.85,18,4,22
2011-03-24 23:00:00,3,1,24.99,38.84,4.92,17,67,84
2011-03-25 00:00:00,3,4,21.4,39.13,8.91,6,13,19
2011-03-25 01:00:00,1,2,11.16,74.94,36.03,35,130,165
2011-03-25 02:00:00,1,2,27.65,88.75,8.74,28,113,141
2011-03-25 03:00:00,1,2,29.11,50.96,7.9,2,185,187
2011-03-25 04:00:00,2,4,21.59,90.05,27.77,12,26,38
2011-03-25 05:00:00,1,4,19.66,47.21,41.75,35,3,38
2011-03-25 06:00:00,3,3,8.42,35.76,13.42,40,127,167
2011-03-25 07:00:00,1,4,7.52,46.37,42.06,24,194,218
2011-03-25 08:00:00,3,3,15.19,68.75,40.4,27,63,90
2011-03-25 09:00:00,4,2,14.33,49.37,28.96,37,85,122
2011-03-25 10:00:00,2,3,33.61,73.83,32.33,10,169,179
2011-03-25 11:00:00,4,1,28.51,38.95,2.02,40,156,196
2011-03-25 12:00:00,4,2,24.8,76.08,18.36,8,79,87
2011-03-25 13:00:00,3,2,20.53,47.8,13.17,21,162,183
2011-03-25 14:00:00,4,3,10.02,56.47,7.5,20,18,38
2011-03-25 15:00:00,3,2,34.35,64.62,19.48,18,115,133
2011-03-25 16:00:00,1,4,16.25,74.9,17.75,32,93,125
2011-03-25 17:00:00,1,1,8.21,39.1,36.44,3,68,71
2011-03-25 18:00:00,3,3,19.81,86.88,29.9,32,30,62
2011-03-25 19:00:00,1,3,31.22,77.75,45.66,44,170,214
2011-03-25 20:00:00,2,2,31.62,38.73,7.27,15,94,109
2011-03-25 21:00:00,4,4,5.33,98.0,2.99,43,148,191
2011-03-25 22:00:00,2,2,31.59,73.18,26.73,0,109,109
2011-03-25 23:00:00,4,2,13.14,56.19,0.05,14,192,206
2011-03-26 00:00:00,1,3,6.17,32.6,39.39,21,161,182
2011-03-26 01:00:00,2,2,30.43,62.66,25.3,31,188,219
2011-03-26 02:00:00,1,1,30.92,33.18,24.4,36,35,71
2011-03-26 03:00:00,4,2,22.89,54.36,18.12,22,40,62
2011-03-26 04:00:00,3,2,22.23,52.7,18.75,32,161,193
2011-03-26 05:00:00,3,3,29.39,77.6,21.56,48,152,200
2011-03-26 06:00:00,2,2,28.59,35.39,0.8,39,184,223
2011-03-26 07:00:00,1,4,31.7,85.75,4.18,21,64,85
2011-03-26 08:00:00,1,3,21.58,46.09,25.25,39,75,114
2011-03-26 09:00:00,2,2,34.03,55.52,7.51,46,123,169
2011-03-26 10:00:00,3,1,34.88,81.79,38.94,11,21,32
2011-03-26 11:00:00,4,1,8.5,70.03,13.72,47,187,234
2011-03-26 12:00:00,2,3,30.49,44.64,4.89,17,181,198
2011-03-26 13:00:00,4,3,19.99,50.9,11.76,31,120,151
2011-03-26 14:00:00,3,2,16.63,44.46,17.85,2,21,23
2011-03-26 15:00:00,1,4,23.39,67.58,1.77,35,188,223
2011-03-26 16:00:00,3,2,6.68,46.61,7.08,46,125,171
2011-03-26 17:00:00,2,1,20.19,78.06,16.19,45,193,238
2011-03-26 18:00:00,1,4,31.13,66.38,15.52,0,172,172
2011-03-26 19:00:00,2,4,11.4,31.66,40.02,24,199,223
2011-03-26 20:00:00,2,4,17.79,44.82,42.16,19,68,87
2011-03-26 21:00:00,3,2,33.18,37.72,9.67,16,191,207
2011-03-26 22:00:00,2,1,17.86,51.23,6.2,48,9,57
2011-03-26 23:00:00,3,3,15.75,61.28,31.71,21,194,215
2011-03-27 00:00:00,1,2,18.22,60.54,40.23,49,10,59
2011-03-27 01:00:00,3,3,20.58,80.36,48.19,32,155,187
2011-03-27 02:00:00,1,4,23.96,35.13,0.34,25,4,29
2011-03-27 03:00:00,3,4,29.02,95.72,20.68,26,11,37
2011-03-27 04:00:00,4,2,18.56,47.43,36.7,33,43,76
2011-03-27 05:00:00,4,1,29.52,44.02,41.43,22,108,130
2011-03-27 06:00:00,2,4,21.01,74.81,3.11,15,92,107
2011-03-27 07:00:00,3,3,15.15,84.44,34.03,13,89,102
2011-03-27 08:00:00,3,3,24.74,50.28,14.45,49,28,77
2011-03-27 09:00:00,1,2,26.53,79.75,3.73,40,35,75
2011-03-27 10:00:00,2,3,21.74,90.7,24.46,13,34,47
2011-03-27 11:00:00,3,1,6.7,81.34,7.91,44,112,156
2011-03-27 12:00:00,2,4,10.1,22.74,36.85,25,7,32
2011-03-27 13:00:00,4,3,13.56,86.19,37.06,45,15,60
2011-03-27 14:00:00,3,3,13.48,81.96,42.1,48,42,90
2011-03-27 15:00:00,3,4,25.2,73.54,18.88,26,68,94
2011-03-27 16:00:00,2,2,5.55,80.8,0.67,39,143,182
2011-03-27 17:00:00,3,3,27.67,98.35,12.99,3,55,58
2011-03-27 18:00:00,2,2,12.96,54.49,23.39,8,40,48
2011-03-27 19:00:00,3,2,14.3,25.38,34.7,26,76,102
2011-03-27 20:00:00,1,3,20.84,56.87,19.1,42,7,49
2011-03-27 21:00:00,2,1,11.48,23.71,26.8,38,53,91
2011-03-27 22:00:00,3,2,31.53,43.54,26.21,14,89,103
2011-03-27 23:00:00,4,3,7.56,66.95,8.25,24,119,143
2011-03-28 00:00:00,3,2,18.33,44.77,31.15,17,132,149
2011-03-28 01:00:00,4,4,30.48,74.83,21.96,29,8,37
2011-03-28 02:00:00,4,1,23.48,85.76,40.4,36,193,229
2011-03-28 03:00:00,1,1,13.77,53.64,34.53,15,70,85
2011-03-28 04:00:00,2,4,17.62,92.01,5.57,11,29,40
2011-03-28 05:00:00,3,4,26.2,26.39,24.44,16,80,96
2011-03-28 06:00:00,1,2,34.2,87.21,35.12,24,107,131
2011-03-28 07:00:00,3,4,31.79,86.29,4.35,14,94,108
2011-03-28 08:00:00,4,1,15.27,45.76,39.62,24,64,88
2011-03-28 09:00:00,2,4,34.95,43.9,11.1,20,29,49
2011-03-28 10:00:00,3,3,5.11,44.41,25.15,18,46,64
2011-03-28 11:00:00,3,3,5.83,84.91,47.03,23,94,117
2011-03-28 12:00:00,4,2,29.72,86.53,28.57,6,87,93
2011-03-28 13:00:00,3,1,10.98,46.38,21.2,11,158,169
2011-03-28 14:00:00,3,3,6.82,67.41,0.34,48,187,235
2011-03-28 15:00:00,4,4,12.11,31.11,6.67,38,74,112
2011-03-28 16:00:00,1,3,17.78,57.5,28.93,10,105,115
2011-03-28 17:00:00,4,3,26.92,99.9,24.69,32,79,111
2011-03-28 18:00:00,1,2,23.73,32.71,18.19,48,136,184
2011-03-28 19:00:00,2,4,12.13,95.81,46.16,24,181,205
2011-03-28 20:00:00,1,4,20.1,85.94,16.62,38,60,98
2011-03-28 21:00:00,1,4,32.79,97.78,26.86,33,191,224
2011-03-28 22:00:00,2,2,29.45,34.37,28.44,10,96,106
2011-03-28 23:00:00,1,4,14.7,37.08,26.37,15,5,20
2011-03-29 00:00:00,4,4,34.47,21.35,23.88,31,44,75
2011-03-29 01:00:00,1,3,26.26,77.98,16.85,14,64,78
2011-03-29 02:00:00,2,3,6.87,71.53,45.44,39,36,75
2011-03-29 03:00:00,4,4,6.05,34.25,22.54,14,89,103
2011-03-29 04:00:00,2,1,10.05,83.29,26.42,6,144,150
2011-03-29 05:00:00,2,1,26.84,43.94,32.82,36,101,137
2011-03-29 06:00:00,3,4,10.51,30.8,3.38,39,109,148
2011-03-29 07:00:00,3,1,20.34,53.81,39.06,1,152,153
2011-03-29 08:00:00,2,2,7.8,27.28,25.63,5,49,54
2011-03-29 09:00:00,2,3,32.63,41.06,32.86,35,122,157
2011-03-29 10:00:00,2,2,15.32,49.71,38.6,38,70,108
2011-03-29 11:00:00,3,3,32.24,88.15,43.7,37,110,147
2011-03-29 12:00:00,3,1,33.35,83.4,19.61,27,30,57
2011-03-29 13:00:00,1,1,5.18,55.42,40.57,21,159,180
2011-03-29 14:00:00,1,4,18.92,77.97,12.94,36,114,150
2011-03-29 15:00:00,2,1,5.74,65.49,33.02,4,47,51
2011-03-29 16:00:00,4,1,32.26,47.27,5.14,17,144,161
2011-03-29 17:00:00,4,4,20.55,78.07,1.0,10,188,198
2011-03-29 18:00:00,3,4,7.25,74.68,4.79,7,184,191
2011-03-29 19:00:00,3,3,8.31,69.53,15.97,19,56,75
2011-03-29 20:00:00,3,1,16.51,69.44,1.55,10,197,207
2011-03-29 21:00:00,2,3,33.21,74.64,31.52,26,160,186
2011-03-29 22:00:00,4,3,25.79,50.76,15.83,28,146,174
2011-03-29 23:00:00,1,2,31.03,89.53,36.82,24,14,38
2011-03-30 00:00:00,2,1,15.99,32.98,2.3,18,162,180
2011-03-30 01:00:00,1,1,6.3,90.71,10.84,1,176,177
2011-03-30 02:00:00,1,2,34.23,47.38,20.4,41,163,204
2011-03-30 03:00:00,2,3,5.52,30.0,19.13,38,53,91
2011-03-30 04:00:00,1,1,33.43,68.0,6.55,43,35,78
2011-03-30 05:00:00,4,3,16.06,50.08,49.71,1,52,53
2011-03-30 06:00:00,1,2,5.3,85.24,14.22,6,187,193
2011-03-30 07:00:00,4,4,25.67,54.46,36.05,30,73,103
2011-03-30 08:00:00,4,3,34.42,73.49,11.0,32,43,75
2011-03-30 09:00:00,4,1,33.97,44.66,43.89,10,32,42
2011-03-30 10:00:00,3,4,9.83,36.76,19.39,39,171,210
2011-03-30 11:00:00,1,3,10.44,51.04,45.05,39,54,93
2011-03-30 12:00:00,2,3,21.97,68.54,17.09,45,43,88
2011-03-30 13:00:00,2,4,24.12,72.56,0.43,12,50,62
2011-03-30 14:00:00,1,4,27.18,66.26,25.85,9,98,107
2011-03-30 15:00:00,3,4,10.43,99.04,26.24,48,85,133
2011-03-30 16:00:00,3,1,33.77,75.29,5.99,37,50,87
2011-03-30 17:00:00,4,1,24.16,94.52,11.75,19,134,153
2011-03-30 18:00:00,1,3,30.41,29.43,39.17,20,128,148
2011-03-30 19:00:00,1,3,21.2,24.91,1.84,13,140,153
2011-03-30 20:00:00,2,2,17.43,44.88,24.48,23,47,70
2011-03-30 21:00:00,1,1,34.32,30.93,26.52,39,126,165
2011-03-30 22:00:00,3,3,22.46,62.07,34.44,6,113,119
2011-03-30 23:00:00,1,4,31.01,61.52,1.87,4,83,87
2011-03-31 00:00:00,2,4,33.6,66.0,29.28,5,174,179
2011-03-31 01:00:00,4,1,25.26,79.62,0.15,39,46,85
2011-03-31 02:00:00,2,4,21.47,97.71,13.26,34,9,43
2011-03-31 03:00:00,2,2,5.11,90.26,24.98,8,25,33
2011-03-31 04:00:00,4,3,6.2,29.47,45.56,41,49,90
2011-03-31 05:00:00,2,3,11.03,47.08,6.33,0,174,174
2011-03-31 06:00:00,2,3,10.58,40.47,8.46,38,171,209
2011-03-31 07:00:00,1,1,12.64,34.15,33.46,19,128,147
2011-03-31 08:00:00,1,4,14.15,63.58,18.74,5,108,113
2011-03-31 09:00:00,4,2,15.8,64.26,31.17,31,62,93
2011-03-31 10:00:00,1,1,17.62,38.18,49.87,12,144,156
2011-03-31 11:00:00,1,3,7.97,76.95,49.34,38,144,182
2011-03-31 12:00:00,2,2,6.27,78.63,17.69,39,166,205
2011-03-31 13:00:00,3,3,25.22,21.68,25.2,20,42,62
2011-03-31 14:00:00,1,3,21.12,51.66,45.23,36,40,76
2011-03-31 15:00:00,3,1,18.32,91.21,4.61,11,14,25
2011-03-31 16:00:00,1,3,24.03,61.63,22.62,5,128,133
2011-03-31 17:00:00,1,2,29.83,47.81,18.88,14,57,71
2011-03-31 18:00:00,4,3,17.83,40.29,14.74,20,53,73
2011-03-31 19:00:00,4,4,24.23,39.47,49.71,20,132,152
2011-03-31 20:00:00,4,3,33.61,27.98,36.68,27,61,88
2011-03-31 21:00:00,3,1,30.19,85.38,19.44,35,126,161
2011-03-31 22:00:00,2,2,17.78,26.93,41.45,16,70,86
2011-03-31 23:00:00,1,1,24.34,43.38,24.48,45,45,90
2011-04-01 00:00:00,1,4,10.31,23.65,43.64,6,89,95
2011-04-01 01:00:00,1,3,21.82,82.51,13.32,22,192,214
2011-04-01 02:00:00,3,1,34.44,23.14,11.18,44,155,199
2011-04-01 03:00:00,4,1,20.55,44.66,12.36,21,121,142
2011-04-01 04:00:00,2,1,32.83,65.86,26.92,9,83,92
2011-04-01 05:00:00,3,1,17.22,52.76,14.57,17,168,185
2011-04-01 06:00:00,4,4,34.97,42.58,7.36,1,150,151
2011-04-01 07:00:00,3,4,22.38,42.02,49.73,11,159,170
2011-04-01 08:00:00,2,3,6.27,83.82,45.02,44,185,229
2011-04-01 09:00:00,4,3,22.6,97.92,31.75,38,166,204
2011-04-01 10:00:00,3,2,13.24,47.84,44.58,49,81,130
2011-04-01 11:00:00,2,4,5.97,23.13,46.77,21,32,53
2011-04-01 12:00:00,1,1,29.63,22.93,33.81,42,185,227
2011-04-01 13:00:00,2,1,13.27,80.74,25.93,21,88,109
2011-04-01 14:00:00,1,2,28.9,64.19,44.1,41,159,200
2011-04-01 15:00:00,3,1,13.65,82.69,28.39,21,113,134
2011-04-01 16:00:00,4,2,10.83,75.8,6.34,5,49,54
2011-04-01 17:00:00,4,3,34.22,92.6,18.34,45,178,223
2011-04-01 18:00:00,3,4,15.85,90.87,22.3,36,18,54
2011-04-01 19:00:00,4,2,23.04,83.07,46.77,19,2,21
2011-04-01 20:00:00,4,1,23.3,58.02,32.96,5,115,120
2011-04-01 21:00:00,1,2,21.81,44.65,43.76,8,90,98
2011-04-01 22:00:00,3,3,32.44,60.56,37.88,28,144,172
2011-04-01 23:00:00,2,1,25.23,60.17,15.49,36,42,78
2011-04-02 00:00:00,1,3,17.11,68.82,35.94,4,156,160
2011-04-02 01:00:00,3,3,30.87,34.89,9.76,12,107,119
2011-04-02 02:00:00,1,2,10.43,72.45,20.41,26,43,69
2011-04-02 03:00:00,2,3,21.33,56.53,40.3,22,51,73
2011-04-02 04:00:00,2,1,33.52,69.62,30.6,36,96,132
2011-04-02 05:00:00,3,3,23.76,39.17,41.27,45,27,72
2011-04-02 06:00:00,2,3,29.51,54.75,12.74,33,108,141
2011-04-02 07:00:00,1,2,24.61,36.82,37.49,24,161,185
2011-04-02 08:00:00,2,3,30.18,90.02,10.12,36,53,89
2011-04-02 09:00:00,1,4,33.33,59.04,27.27,22,1,23
2011-04-02 10:00:00,1,2,13.19,38.0,21.68,27,113,140
2011-04-02 11:00:00,2,2,10.09,23.3,27.82,25,16,41
2011-04-02 12:00:00,3,1,19.52,74.06,6.78,11,145,156
2011-04-02 13:00:00,4,1,26.06,37.17,18.06,38,27,65
2011-04-02 14:00:00,2,1,11.82,99.17,33.35,2,27,29
2011-04-02 15:00:00,1,1,5.12,62.7,27.93,8,179,187
2011-04-02 16:00:00,1,4,15.29,43.12,27.45,46,15,61
2011-04-02 17:00:00,2,2,34.07,72.61,25.54,14,160,174
2011-04-02 18:00:00,3,3,25.85,42.02,47.19,7,84,91
2011-04-02 19:00:00,3,1,17.04,85.62,46.73,27,4,31
2011-04-02 20:00:00,1,1,10.78,44.66,18.01,25,44,69
2011-04-02 21:00:00,1,1,15.68,99.06,17.59,15,164,179
2011-04-02 22:00:00,3,3,10.1,68.41,27.74,33,51,84
2011-04-02 23:00:00,4,1,8.19,87.55,4.78,19,191,210
2011-04-03 00:00:00,2,3,32.2,25.83,15.15,0,61,61
2011-04-03 01:00:00,1,2,34.93,47.86,11.54,23,4,27
2011-04-03 02:00:00,1,2,9.92,79.0,11.17,28,106,134
2011-04-03 03:00:00,3,2,6.64,72.4,31.93,3,10,13
2011-04-03 04:00:00,2,4,14.89,35.54,19.22,3,85,88
2011-04-03 05:00:00,3,3,18.85,48.5,8.56,37,130,167
2011-04-03 06:00:00,2,1,11.14,41.08,44.38,2,178,180
2011-04-03 07:00:00,2,1,14.04,69.07,43.71,39,59,98
2011-04-03 08:00:00,2,1,11.03,47.57,43.12,1,65,66
2011-04-03 09:00:00,1,1,28.23,44.72,19.54,28,184,212
2011-04-03 10:00:00,4,4,26.38,36.59,2.85,48,16,64
2011-04-03 11:00:00,3,1,24.05,52.72,5.34,27,130,157
2011-04-03 12:00:00,4,4,16.62,35.64,13.8,11,130,141
2011-04-03 13:00:00,3,3,32.27,97.01,11.0,43,39,82
2011-04-03 14:00:00,2,2,34.09,32.36,43.7,14,79,93
2011-04-03 15:00:00,1,1,10.21,93.06,49.32,49,75,124
2011-04-03 16:00:00,4,2,11.69,54.28,40.83,40,62,102
2011-04-03 17:00:00,1,3,20.77,50.23,36.49,30,50,80
2011-04-03 18:00:00,3,3,7.74,38.51,29.43,36,128,164
2011-04-03 19:00:00,1,1,18.09,70.86,38.5,31,50,81
2011-04-03 20:00:00,1,3,22.45,74.84,47.35,21,3,24
2011-04-03 21:00:00,4,2,20.66,57.41,30.07,2,131,133
2011-04-03 22:00:00,2,1,14.93,24.46,7.73,16,174,190
2011-04-03 23:00:00,1,4,21.27,93.48,8.19,28,166,194
2011-04-04 00:00:00,2,1,33.76,98.43,29.19,11,83,94
2011-04-04 01:00:00,3,2,11.18,54.48,16.67,13,48,61
2011-04-04 02:00:00,1,1,24.64,69.09,45.51,7,184,191
2011-04-04 03:00:00,4,1,6.3,56.02,30.58,40,38,78
2011-04-04 04:00:00,3,2,6.99,45.75,33.82,1,195,196
2011-04-04 05:00:00,3,1,21.55,26.19,0.29,33,144,177
2011-04-04 06:00:00,4,1,8.15,56.49,24.94,23,142,165
2011-04-04 07:00:00,1,2,5.67,85.47,21.56,47,104,151
2011-04-04 08:00:00,1,3,10.15,21.36,35.29,19,155,174
2011-04-04 09:00:00,3,2,21.95,66.57,19.13,42,15,57
2011-04-04 10:00:00,1,1,26.1,90.46,48.83,9,133,142
2011-04-04 11:00:00,2,4,11.07,37.4,33.51,39,91,130
2011-04-04 12:00:00,4,4,25.05,34.66,33.0,6,159,165
2011-04-04 13:00:00,2,2,10.47,81.78,45.97,0,24,24
2011-04-04 14:00:00,1,4,23.4,40.41,49.76,9,38,47
2011-04-04 15:00:00,3,1,17.36,35.36,9.89,4,144,148
2011-04-04 16:00:00,4,1,24.61,50.24,40.53,39,45,84
2011-04-04 17:00:00,1,2,34.85,51.4,8.12,20,115,135
2011-04-04 18:00:00,1,1,33.13,89.93,22.85,8,52,60
2011-04-04 19:00:00,3,3,5.13,69.48,5.01,28,113,141
2011-04-04 20:00:00,3,1,31.56,52.48,31.17,30,50,80
2011-04-04 21:00:00,2,2,6.99,62.75,23.43,44,145,189
2011-04-04 22:00:00,4,3,33.59,96.32,31.43,45,19,64
2011-04-04 23:00:00,4,3,13.45,29.06,33.9,26,86,112
2011-04-05 00:00:00,3,4,16.46,36.62,30.97,5,132,137
2011-04-05 01:00:00,2,1,7.75,97.0,14.7,42,61,103
2011-04-05 02:00:00,4,2,8.37,96.59,41.85,30,102,132
2011-04-05 03:00:00,3,4,26.8,34.17,27.58,40,11,51
2011-04-05 04:00:00,1,4,33.33,31.61,24.49,44,80,124
2011-04-05 05:00:00,4,1,23.32,53.69,49.35,35,157,192
2011-04-05 06:00:00,2,1,26.48,23.98,14.18,1,143,144
2011-04-05 07:00:00,2,2,27.86,72.39,26.4,20,1,21
2011-04-05 08:00:00,2,4,12.88,26.2,34.12,33,124,157
2011-04-05 09:00:00,1,2,6.36,24.64,6.26,21,116,137
2011-04-05 10:00:00,4,4,5.06,58.81,17.71,12,130,142
2011-04-05 11:00:00,4,4,15.52,96.62,40.08,18,7,25
2011-04-05 12:00:00,1,4,12.24,54.14,11.84,32,36,68
2011-04-05 13:00:00,4,1,6.87,48.52,24.66,37,180,217
2011-04-05 14:00:00,1,4,10.39,99.84,31.53,39,54,93
2011-04-05 15:00:00,1,4,8.73,62.56,33.56,48,48,96
2011-04-05 16:00:00,1,4,32.45,50.02,36.42,2,58,60
2011-04-05 17:00:00,2,3,9.21,50.87,43.3,37,59,96
2011-04-05 18:00:00,4,1,21.13,35.6,19.64,18,88,106
2011-04-05 19:00:00,1,3,22.79,60.98,35.33,6,77,83
2011-04-05 20:00:00,4,1,21.3,55.11,36.61,14,118,132
2011-04-05 21:00:00,2,2,7.97,41.66,15.01,37,173,210
2011-04-05 22:00:00,1,3,14.56,32.84,48.41,24,99,123
2011-04-05 23:00:00,3,2,6.54,44.9,43.26,21,62,83
2011-04-06 00:00:00,2,4,16.87,60.69,14.49,22,126,148
2011-04-06 01:00:00,3,2,10.66,24.67,33.75,49,159,208
2011-04-06 02:00:00,4,2,21.85,32.3,35.89,9,65,74
2011-04-06 03:00:00,4,2,25.78,95.81,21.57,35,84,119
2011-04-06 04:00:00,2,2,20.96,63.43,43.19,36,3,39
2011-04-06 05:00:00,4,1,18.03,25.08,34.51,49,156,205
2011-04-06 06:00:00,3,3,16.62,75.45,32.91,41,176,217
2011-04-06 07:00:00,1,1,30.25,24.94,11.04,41,92,133
2011-04-06 08:00:00,1,1,11.58,79.11,20.39,41,22,63
2011-04-06 09:00:00,1,1,27.03,80.0,21.7,6,130,136
2011-04-06 10:00:00,2,2,27.72,72.09,36.68,45,53,98
2011-04-06 11:00:00,4,1,17.58,78.58,30.92,24,148,172
2011-04-06 12:00:00,3,3,13.92,27.04,4.29,39,79,118
2011-04-06 13:00:00,4,1,19.12,78.14,15.38,40,43,83
2011-04-06 14:00:00,4,4,7.8,30.94,23.65,23,147,170
2011-04-06 15:00:00,4,2,6.38,47.16,36.84,4,184,188
2011-04-06 16:00:00,1,4,8.35,95.42,37.18,20,196,216
2011-04-06 17:00:00,3,3,10.61,60.23,24.53,39,198,237
2011-04-06 18:00:00,3,3,20.13,97.39,5.85,19,179,198
2011-04-06 19:00:00,4,3,30.47,27.11,14.65,28,144,172
2011-04-06 20:00:00,1,3,12.07,58.2,12.73,36,193,229
2011-04-06 21:00:00,1,1,33.05,24.99,39.05,19,11,30
2011-04-06 22:00:00,3,2,33.65,70.42,9.0,17,185,202
2011-04-06 23:00:00,1,3,33.77,26.3,23.25,3,132,135
2011-04-07 00:00:00,1,4,30.13,34.03,33.54,10,79,89
2011-04-07 01:00:00,1,3,15.91,40.71,48.24,21,125,146
2011-04-07 02:00:00,2,2,7.18,79.9,49.96,42,91,133
2011-04-07 03:00:00,4,4,22.06,33.12,47.65,13,71,84
2011-04-07 04:00:00,3,4,21.76,87.73,35.91,44,183,227
2011-04-07 05:00:00,3,4,30.5,30.55,37.32,27,45,72
2011-04-07 06:00:00,2,1,34.88,22.82,37.96,3,71,74
2011-04-07 07:00:00,4,3,20.24,51.6,43.13,15,92,107
2011-04-07 08:00:00,3,1,15.36,98.36,47.59,37,120,157
2011-04-07 09:00:00,1,4,10.58,28.83,22.29,22,17,39
2011-04-07 10:00:00,3,1,5.14,28.14,20.83,12,43,55
2011-04-07 11:00:00,1,1,20.27,80.09,23.02,19,42,61
2011-04-07 12:00:00,2,1,21.67,44.97,32.99,4,78,82
2011-04-07 13:00:00,1,3,29.75,77.38,38.77,18,76,94
2011-04-07 14:00:00,3,4,20.14,36.0,43.53,20,149,169
2011-04-07 15:00:00,3,4,32.49,56.81,22.81,41,59,100
2011-04-07 16:00:00,3,3,23.84,41.22,18.17,4,62,66
2011-04-07 17:00:00,2,1,30.21,56.12,49.17,13,23,36
2011-04-07 18:00:00,2,1,9.45,81.53,11.59,35,192,227
2011-04-07 19:00:00,4,2,30.66,80.96,11.1,5,28,33
2011-04-07 20:00:00,3,2,25.25,61.26,35.77,4,128,132
2011-04-07 21:00:00,1,2,10.11,94.27,8.98,23,123,146
2011-04-07 22:00:00,2,3,10.69,41.1,19.97,28,0,28
2011-04-07 23:00:00,3,4,32.8,39.22,14.62,28,72,100
2011-04-08 00:00:00,3,2,5.97,69.1,8.44,1,20,21
2011-04-08 01:00:00,2,4,18.88,69.7,28.99,5,155,160
2011-04-08 02:00:00,4,4,14.4,23.72,18.68,33,145,178
2011-04-08 03:00:00,2,4,24.95,68.62,23.11,11,96,107
2011-04-08 04:00:00,2,3,30.19,49.95,9.79,21,51,72
2011-04-08 05:00:00,1,3,15.81,79.8,38.39,3,65,68
2011-04-08 06:00:00,1,3,17.81,84.65,15.74,44,114,158
2011-04-08 07:00:00,4,3,34.46,64.17,17.14,48,87,135
2011-04-08 08:00:00,3,2,28.52,20.14,12.61,5,61,66
2011-04-08 09:00:00,2,1,31.92,70.91,21.72,2,18,20
2011-04-08 10:00:00,4,1,18.16,79.91,23.18,12,1,13
2011-04-08 11:00:00,1,1,12.02,39.92,26.48,22,197,219
2011-04-08 12:00:00,2,2,17.36,57.17,48.38,34,54,88
2011-04-08 13:00:00,3,1,26.48,97.26,45.23,25,78,103
2011-04-08 14:00:00,1,2,8.28,43.85,30.47,8,184,192
2011-04-08 15:00:00,1,2,13.11,37.85,1.95,22,10,32
2011-04-08 16:00:00,1,2,6.4,36.87,30.61,3,143,146
2011-04-08 17:00:00,4,1,17.97,64.7,4.48,33,84,117
2011-04-08 18:00:00,3,4,29.82,95.98,35.52,36,189,225
2011-04-08 19:00:00,2,1,5.74,68.7,19.5,7,26,33
2011-04-08 20:00:00,4,1,25.26,44.27,41.88,33,21,54
2011-04-08 21:00:00,4,3,32.97,71.09,47.13,36,2,38
2011-04-08 22:00:00,4,2,12.11,69.99,20.86,5,2,7
2011-04-08 23:00:00,1,4,25.81,67.75,23.03,6,148,154
2011-04-09 00:00:00,3,3,34.25,32.75,29.51,44,42,86
2011-04-09 01:00:00,4,4,33.87,70.77,9.86,40,197,237
2011-04-09 02:00:00,2,4,12.05,54.41,46.37,38,88,126
2011-04-09 03:00:00,3,2,8.01,21.49,21.65,35,36,71
2011-04-09 04:00:00,2,1,9.45,63.18,8.34,4,93,97
2011-04-09 05:00:00,3,2,26.06,99.14,38.14,2,183,185
2011-04-09 06:00:00,2,2,26.77,47.98,10.96,16,38,54
2011-04-09 07:00:00,1,3,25.23,97.24,7.18,18,147,165
2011-04-09 08:00:00,4,2,15.08,27.7,28.14,44,64,108
2011-04-09 09:00:00,2,1,10.09,78.6,33.57,0,162,162
2011-04-09 10:00:00,3,4,22.42,29.15,28.48,36,42,78
2011-04-09 11:00:00,4,2,19.51,41.89,32.83,8,20,28
2011-04-09 12:00:00,4,4,26.87,65.67,5.78,3,9,12
2011-04-09 13:00:00,3,2,18.24,67.42,23.8,41,44,85
2011-04-09 14:00:00,2,4,15.16,82.02,17.85,45,92,137
2011-04-09 15:00:00,1,2,13.8,69.22,48.67,9,2,11
2011-04-09 16:00:00,1,3,11.34,67.49,2.48,31,42,73
2011-04-09 17:00:00,2,4,12.97,92.99,14.91,0,179,179
2011-04-09 18:00:00,4,2,7.84,56.17,47.09,22,40,62
2011-04-09 19:00:00,4,2,15.41,38.02,49.17,16,120,136
2011-04-09 20:00:00,4,3,6.1,32.94,41.25,29,106,135
2011-04-09 21:00:00,4,3,10.59,52.0,3.8,26,168,194
2011-04-09 22:00:00,2,3,27.4,77.02,28.07,14,8,22
2011-04-09 23:00:00,4,4,14.76,23.4,20.01,37,173,210
2011-04-10 00:00:00,3,4,25.05,30.32,40.32,6,143,149
2011-04-10 01:00:00,4,3,26.51,28.49,2.75,32,123,155
2011-04-10 02:00:00,1,1,22.44,66.82,9.86,4,112,116
2011-04-10 03:00:00,4,1,33.76,39.43,24.46,38,120,158
2011-04-10 04:00:00,2,2,5.64,33.3,7.88,33,46,79
2011-04-10 05:00:00,1,1,27.16,67.42,34.64,2,155,157
2011-04-10 06:00:00,2,2,33.76,80.9,41.04,31,27,58
2011-04-10 07:00:00,2,4,30.87,46.57,35.23,1,74,75
2011-04-10 08:00:00,1,4,10.04,66.26,22.01,15,93,108
2011-04-10 09:00:00,2,1,14.8,27.85,43.92,16,138,154
2011-04-10 10:00:00,2,4,10.17,94.82,6.88,11,28,39
2011-04-10 11:00:00,4,3,23.04,46.95,13.02,4,183,187
2011-04-10 12:00:00,3,3,26.37,99.8,24.48,3,199,202
2011-04-10 13:00:00,2,1,14.51,98.29,3.07,15,56,71
2011-04-10 14:00:00,2,1,21.19,82.31,4.78,17,180,197
2011-04-10 15:00:00,2,2,25.73,21.61,19.87,44,73,117
2011-04-10 16:00:00,4,4,17.64,63.48,47.19,19,118,137
2011-04-10 17:00:00,3,2,30.62,26.95,45.42,8,58,66
2011-04-10 18:00:00,1,2,28.15,91.61,23.3,15,34,49
2011-04-10 19:00:00,4,3,6.94,83.17,7.11,34,179,213
2011-04-10 20:00:00,4,3,23.63,97.79,8.91,28,35,63
2011-04-10 21:00:00,3,3,12.06,68.67,18.88,48,76,124
2011-04-10 22:00:00,3,3,21.73,61.77,10.5,29,57,86
2011-04-10 23:00:00,4,2,33.71,61.52,4.15,19,1,20
2011-04-11 00:00:00,1,3,31.37,50.92,33.69,41,27,68
2011-04-11 01:00:00,4,4,17.14,57.5,29.07,21,69,90
2011-04-11 02:00:00,3,3,13.75,70.83,14.56,22,62,84
2011-04-11 03:00:00,1,3,12.03,94.64,38.95,35,179,214
2011-04-11 04:00:00,3,3,20.98,67.67,38.8,21,59,80
2011-04-11 05:00:00,1,1,8.43,88.57,24.55,0,89,89
2011-04-11 06:00:00,2,4,21.48,89.02,4.83,20,163,183
2011-04-11 07:00:00,3,4,5.04,61.51,45.92,47,103,150
2011-04-11 08:00:00,3,2,14.72,47.8,33.43,42,189,231
2011-04-11 09:00:00,4,2,11.6,71.17,12.35,18,115,133
2011-04-11 10:00:00,3,3,34.14,55.67,30.52,7,42,49
2011-04-11 11:00:00,3,1,26.82,26.52,20.25,4,166,170
2011-04-11 12:00:00,2,2,15.49,50.22,31.77,39,132,171
2011-04-11 13:00:00,3,2,7.79,99.53,23.69,28,177,205
2011-04-11 14:00:00,2,3,20.5,23.88,24.27,17,15,32
2011-04-11 15:00:00,2,3,11.4,75.73,36.79,28,51,79
2011-04-11 16:00:00,2,2,21.09,87.3,30.69,14,196,210
2011-04-11 17:00:00,2,2,30.06,71.9,4.0,49,70,119
2011-04-11 18:00:00,1,4,23.47,65.58,3.27,44,2,46
2011-04-11 19:00:00,4,1,24.01,76.6,15.25,30,88,118
2011-04-11 20:00:00,1,4,21.23,54.35,21.51,14,137,151
2011-04-11 21:00:00,3,2,32.82,27.31,13.76,44,50,94
2011-04-11 22:00:00,1,4,32.96,96.99,32.57,2,196,198
2011-04-11 23:00:00,1,4,20.38,54.58,9.76,43,159,202
2011-04-12 00:00:00,3,2,14.17,73.23,35.21,43,132,175
2011-04-12 01:00:00,3,3,18.79,62.5,38.66,41,117,158
2011-04-12 02:00:00,3,2,10.6,24.37,6.22,32,170,202
2011-04-12 03:00:00,1,3,24.09,96.22,32.54,23,139,162
2011-04-12 04:00:00,1,2,20.0,83.4,48.07,37,158,195
2011-04-12 05:00:00,3,2,8.1,31.93,9.64,23,149,172
2011-04-12 06:00:00,4,2,10.93,98.53,45.47,12,58,70
2011-04-12 07:00:00,4,1,19.39,78.95,30.3,26,51,77
2011-04-12 08:00:00,2,3,31.63,57.79,29.55,32,46,78
2011-04-12 09:00:00,3,1,21.99,68.91,2.6,18,104,122
2011-04-12 10:00:00,2,2,25.45,28.54,37.42,24,48,72
2011-04-12 11:00:00,4,4,15.17,64.83,23.91,5,55,60
2011-04-12 12:00:00,2,1,22.14,25.89,36.06,32,30,62
2011-04-12 13:00:00,3,3,18.42,63.59,40.46,24,186,210
2011-04-12 14:00:00,3,2,24.77,64.22,26.19,22,69,91
2011-04-12 15:00:00,3,1,6.52,89.96,13.18,48,75,123
2011-04-12 16:00:00,1,4,19.8,78.0,7.08,16,170,186
2011-04-12 17:00:00,2,1,13.88,39.96,8.03,20,80,100
2011-04-12 18:00:00,4,3,14.79,91.07,43.35,42,73,115
2011-04-12 19:00:00,4,1,33.83,65.86,6.18,19,108,127
2011-04-12 20:00:00,4,4,10.48,68.51,19.23,11,4,15
2011-04-12 21:00:00,1,4,14.34,33.52,16.71,12,3,15
2011-04-12 22:00:00,1,3,20.3,88.62,43.27,17,142,159
2011-04-12 23:00:00,3,4,30.89,94.48,23.88,21,129,150
2011-04-13 00:00:00,4,2,17.5,82.0,49.82,23,176,199
2011-04-13 01:00:00,1,4,27.32,95.26,36.85,32,55,87
2011-04-13 02:00:00,3,2,30.69,44.18,42.55,2,135,137
2011-04-13 03:00:00,4,1,14.3,88.89,4.93,16,15,31
2011-04-13 04:00:00,2,2,16.78,59.11,12.66,38,191,229
2011-04-13 05:00:00,3,2,15.7,33.11,6.77,31,23,54
2011-04-13 06:00:00,1,1,29.99,73.5,23.18,16,54,70
2011-04-13 07:00:00,1,4,6.33,74.73,35.91,47,181,228
2011-04-13 08:00:00,3,2,14.25,42.95,8.45,43,68,111
2011-04-13 09:00:00,3,4,25.38,22.2,6.51,24,59,83
2011-04-13 10:00:00,1,1,21.96,35.99,30.73,7,158,165
2011-04-13 11:00:00,2,3,18.09,51.98,11.52,42,19,61
2011-04-13 12:00:00,4,4,21.2,33.41,23.97,34,53,87
2011-04-13 13:00:00,2,4,10.93,35.52,2.56,28,136,164
2011-04-13 14:00:00,3,3,17.92,51.31,34.03,11,161,172
2011-04-13 15:00:00,2,3,20.05,96.94,27.07,35,79,114
2011-04-13 16:00:00,1,1,32.04,81.14,32.37,8,192,200
2011-04-13 17:00:00,3,4,12.83,45.58,13.77,25,143,168
2011-04-13 18:00:00,4,4,31.03,96.13,13.93,21,69,90
2011-04-13 19:00:00,1,1,24.33,71.65,40.07,30,133,163
2011-04-13 20:00:00,1,4,5.61,56.44,35.93,48,34,82
2011-04-13 21:00:00,4,2,26.74,57.46,28.99,47,104,151
2011-04-13 22:00:00,4,2,6.07,52.86,31.41,43,130,173
2011-04-13 23:00:00,2,2,34.92,38.64,4.7,29,20,49
2011-04-14 00:00:00,3,4,31.18,50.93,42.81,14,134,148
2011-04-14 01:00:00,4,2,13.92,62.23,38.5,46,77,123
2011-04-14 02:00:00,4,2,12.72,62.24,29.52,32,157,189
2011-04-14 03:00:00,3,1,16.44,80.94,45.93,2,21,23
2011-04-14 04:00:00,4,1,15.69,48.7,8.43,33,141,174
2011-04-14 05:00:00,4,3,16.17,77.34,34.33,16,182,198
2011-04-14 06:00:00,2,3,14.55,66.25,48.15,43,88,131
2011-04-14 07:00:00,1,3,23.63,96.95,15.5,4,66,70
2011-04-14 08:00:00,1,3,9.93,50.82,0.76,29,132,161
2011-04-14 09:00:00,1,1,30.38,92.1,36.74,42,196,238
2011-04-14 10:00:00,1,1,29.37,85.65,0.35,14,114,128
2011-04-14 11:00:00,4,1,19.29,71.01,43.63,38,58,96
2011-04-14 12:00:00,3,2,30.58,72.36,2.82,7,136,143
2011-04-14 13:00:00,3,2,12.41,26.77,32.64,41,175,216
2011-04-14 14:00:00,2,3,5.53,96.02,18.86,37,101,138
2011-04-14 15:00:00,2,2,23.58,28.55,10.17,27,36,63
2011-04-14 16:00:00,4,4,18.74,65.06,44.91,20,67,87
2011-04-14 17:00:00,3,1,22.01,46.41,37.31,46,147,193
2011-04-14 18:00:00,3,3,31.98,54.39,17.02,9,84,93
2011-04-14 19:00:00,1,3,34.1,68.81,14.21,27,177,204
2011-04-14 20:00:00,4,4,24.03,92.71,36.8,20,23,43
2011-04-14 21:00:00,4,2,27.92,56.61,41.83,48,123,171
2011-04-14 22:00:00,1,3,7.51,99.02,35.79,27,198,225
2011-04-14 23:00:00,4,2,9.82,67.42,32.0,21,125,146
2011-04-15 00:00:00,4,2,27.0,32.84,11.4,37,48,85
2011-04-15 01:00:00,2,4,17.94,35.2,42.64,18,135,153
2011-04-15 02:00:00,3,3,18.38,77.29,37.48,37,74,111
2011-04-15 03:00:00,4,2,14.26,24.03,25.86,45,109,154
2011-04-15 04:00:00,2,2,23.22,58.43,25.58,23,5,28
2011-04-15 05:00:00,3,4,10.55,31.86,28.46,27,39,66
2011-04-15 06:00:00,1,4,23.81,54.66,41.41,44,80,124
2011-04-15 07:00:00,2,2,10.21,79.99,37.11,12,181,193
2011-04-15 08:00:00,2,4,6.91,56.71,42.81,8,108,116
2011-04-15 09:00:00,3,2,14.91,33.08,25.36,8,144,152
2011-04-15 10:00:00,1,3,11.93,40.15,31.23,20,50,70
2011-04-15 11:00:00,2,1,31.67,49.4,42.73,23,1,24
2011-04-15 12:00:00,4,4,6.65,25.56,11.62,30,157,187
2011-04-15 13:00:00,4,1,10.3,66.75,22.2,28,159,187
2011-04-15 14:00:00,4,2,21.46,68.6,31.03,39,49,88
2011-04-15 15:00:00,1,2,19.43,24.97,45.76,9,198,207
2011-04-15 16:00:00,2,2,6.38,52.18,0.79,3,143,146
2011-04-15 17:00:00,4,1,5.22,53.12,10.63,2,82,84
2011-04-15 18:00:00,1,2,34.64,46.71,11.72,12,182,194
2011-04-15 19:00:00,4,4,24.77,64.62,16.33,20,184,204
2011-04-15 20:00:00,3,3,15.96,47.68,14.09,7,44,51
2011-04-15 21:00:00,2,3,19.11,53.31,29.51,8,179,187
2011-04-15 22:00:00,2,4,13.0,83.8,44.28,45,198,243
2011-04-15 23:00:00,1,3,15.35,32.97,31.85,0,174,174
2011-04-16 00:00:00,1,1,24.47,69.53,12.08,13,32,45
2011-04-16 01:00:00,2,2,31.48,60.45,43.19,11,127,138
2011-04-16 02:00:00,4,2,10.52,44.41,31.6,35,97,132
2011-04-16 03:00:00,4,2,30.21,78.2,10.95,21,151,172
2011-04-16 04:00:00,3,1,8.65,64.1,18.08,35,34,69
2011-04-16 05:00:00,4,1,11.45,58.19,39.5,44,191,235
2011-04-16 06:00:00,1,1,6.12,73.41,36.95,15,84,99
2011-04-16 07:00:00,1,4,9.22,84.18,28.83,10,87,97
2011-04-16 08:00:00,4,1,32.52,97.81,7.24,2,100,102
2011-04-16 09:00:00,1,3,18.78,70.35,40.16,33,59,92
2011-04-16 10:00:00,2,4,7.33,89.96,15.38,24,28,52
2011-04-16 11:00:00,2,4,33.79,20.09,38.58,25,17,42
2011-04-16 12:00:00,4,4,31.37,62.42,32.38,2,185,187
2011-04-16 13:00:00,2,1,27.64,37.17,13.21,19,47,66
2011-04-16 14:00:00,2,4,33.0,27.54,10.62,30,10,40
2011-04-16 15:00:00,3,1,11.6,62.56,6.55,48,130,178
2011-04-16 16:00:00,3,1,30.09,79.75,12.1,0,169,169
2011-04-16 17:00:00,2,4,25.7,52.98,7.89,25,145,170
2011-04-16 18:00:00,4,2,31.09,73.61,30.85,24,15,39
2011-04-16 19:00:00,3,2,28.91,59.18,29.94,10,40,50
2011-04-16 20:00:00,1,4,15.39,54.97,29.31,15,192,207
2011-04-16 21:00:00,1,2,28.23,43.22,32.09,19,42,61
2011-04-16 22:00:00,1,3,12.87,50.61,40.74,41,170,211
2011-04-16 23:00:00,4,3,14.86,47.98,45.68,37,90,127
2011-04-17 00:00:00,2,1,8.24,71.69,11.52,1,30,31
2011-04-17 01:00:00,1,2,33.05,29.28,29.39,28,27,55
2011-04-17 02:00:00,4,3,13.73,27.41,3.92,6,50,56
2011-04-17 03:00:00,3,4,20.62,72.8,6.01,48,26,74
2011-04-17 04:00:00,2,2,16.74,63.7,32.72,39,8,47
2011-04-17 05:00:00,3,3,33.8,54.42,24.33,44,120,164
2011-04-17 06:00:00,4,3,15.05,32.2,37.92,24,123,147
2011-04-17 07:00:00,1,4,28.36,52.88,21.28,3,165,168
2011-04-17 08:00:00,1,1,30.66,83.18,6.38,42,163,205
2011-04-17 09:00:00,4,4,18.07,91.17,43.6,33,59,92
2011-04-17 10:00:00,1,1,16.35,76.21,4.14,24,56,80
2011-04-17 11:00:00,2,3,27.43,24.79,9.45,7,174,181
2011-04-17 12:00:00,4,1,32.39,73.63,13.85,31,113,144
2011-04-17 13:00:00,3,3,27.65,39.28,49.76,17,67,84
2011-04-17 14:00:00,4,3,11.81,45.22,20.84,39,50,89
2011-04-17 15:00:00,2,2,31.65,35.67,25.09,10,57,67
2011-04-17 16:00:00,2,1,16.63,82.06,38.48,36,47,83
2011-04-17 17:00:00,4,1,22.29,71.89,31.82,38,58,96
2011-04-17 18:00:00,4,1,29.94,68.95,42.07,35,75,110
2011-04-17 19:00:00,1,4,10.65,73.44,24.32,9,46,55
2011-04-17 20:00:00,2,2,28.54,38.94,48.61,5,142,147
2011-04-17 21:00:00,4,2,22.88,55.57,39.84,44,110,154
2011-04-17 22:00:00,4,2,31.8,70.66,20.07,15,111,126
2011-04-17 23:00:00,2,4,10.16,70.93,19.06,24,71,95
2011-04-18 00:00:00,4,1,17.62,83.35,46.47,33,120,153
2011-04-18 01:00:00,1,1,29.99,42.97,34.22,30,94,124
2011-04-18 02:00:00,2,1,5.58,81.63,31.07,46,1,47
2011-04-18 03:00:00,1,2,8.37,55.21,37.89,7,78,85
2011-04-18 04:00:00,1,2,34.72,73.61,28.04,16,188,204
2011-04-18 05:00:00,1,3,13.41,56.46,7.96,13,39,52
2011-04-18 06:00:00,1,4,34.27,95.89,15.96,29,170,199
2011-04-18 07:00:00,2,4,10.48,34.34,27.9,17,47,64
2011-04-18 08:00:00,1,2,15.83,74.0,0.91,45,199,244
2011-04-18 09:00:00,1,3,27.59,66.12,21.87,35,196,231
2011-04-18 10:00:00,4,1,24.73,33.82,37.79,20,56,76
2011-04-18 11:00:00,2,2,22.43,25.28,8.21,30,195,225
2011-04-18 12:00:00,2,4,20.9,83.93,3.23,32,11,43
2011-04-18 13:00:00,3,4,30.3,32.6,41.8,22,67,89
2011-04-18 14:00:00,2,4,12.05,34.92,30.86,37,178,215
2011-04-18 15:00:00,2,1,18.27,98.27,8.83,4,73,77
2011-04-18 16:00:00,3,4,9.66,77.38,40.32,14,28,42
2011-04-18 17:00:00,2,1,22.88,40.04,32.91,29,91,120
2011-04-18 18:00:00,2,1,12.52,67.28,16.71,15,28,43
2011-04-18 19:00:00,2,1,15.02,62.73,18.81,39,82,121
2011-04-18 20:00:00,2,2,19.14,87.56,7.79,28,114,142
2011-04-18 21:00:00,3,1,5.8,78.35,41.76,27,106,133
2011-04-18 22:00:00,2,3,7.76,86.54,25.45,5,140,145
2011-04-18 23:00:00,2,4,25.58,36.92,27.85,4,184,188
2011-04-19 00:00:00,3,2,17.87,71.22,44.17,37,97,134
2011-04-19 01:00:00,4,4,30.94,23.22,0.79,24,45,69
2011-04-19 02:00:00,1,1,25.84,25.52,3.35,27,19,46
2011-04-19 03:00:00,4,2,5.24,77.08,8.08,0,58,58
2011-04-19 04:00:00,3,3,23.5,21.95,1.5,13,119,132
2011-04-19 05:00:00,1,1,7.81,66.38,32.91,18,35,53
2011-04-19 06:00:00,3,4,28.43,87.23,31.69,30,0,30
2011-04-19 07:00:00,3,3,34.75,50.4,10.54,14,89,103
2011-04-19 08:00:00,2,1,20.94,23.59,7.47,18,130,148
2011-04-19 09:00:00,1,3,25.48,77.11,7.28,37,43,80
2011-04-19 10:00:00,2,1,12.12,94.37,47.66,31,182,213
2011-04-19 11:00:00,1,2,18.13,77.37,34.68,30,59,89
2011-04-19 12:00:00,3,1,30.68,66.28,29.27,36,130,166
2011-04-19 13:00:00,3,2,10.02,38.4,16.12,25,84,109
2011-04-19 14:00:00,4,1,12.97,21.23,21.65,47,190,237
2011-04-19 15:00:00,1,1,18.36,75.57,4.47,40,81,121
2011-04-19 16:00:00,2,4,26.37,38.48,49.91,24,158,182
2011-04-19 17:00:00,4,3,16.28,88.65,37.75,46,60,106
2011-04-19 18:00:00,4,3,32.83,57.31,31.07,39,48,87
2011-04-19 19:00:00,4,3,7.83,62.45,29.39,7,43,50
2011-04-19 20:00:00,2,1,16.12,80.31,25.22,3,179,182
2011-04-19 21:00:00,4,1,26.27,82.35,12.87,30,30,60
2011-04-19 22:00:00,2,1,11.78,71.41,11.32,31,71,102
2011-04-19 23:00:00,4,2,24.69,95.07,27.48,33,88,121
2011-04-20 00:00:00,2,2,9.93,98.58,3.51,47,176,223
2011-04-20 01:00:00,3,4,6.68,95.75,3.72,2,45,47
2011-04-20 02:00:00,3,1,8.63,85.93,28.04,40,181,221
2011-04-20 03:00:00,3,3,32.9,76.45,45.99,25,138,163
2011-04-20 04:00:00,3,3,21.55,73.07,45.71,3,103,106
2011-04-20 05:00:00,3,4,28.89,28.3,0.54,1,64,65
2011-04-20 06:00:00,4,3,14.98,41.72,5.37,18,144,162
2011-04-20 07:00:00,4,4,22.78,20.46,29.15,22,115,137
2011-04-20 08:00:00,4,1,19.85,30.99,42.42,24,27,51
2011-04-20 09:00:00,2,3,33.37,55.14,47.72,46,81,127
2011-04-20 10:00:00,2,1,27.43,31.72,43.03,6,73,79
2011-04-20 11:00:00,2,2,26.92,92.13,33.88,7,8,15
2011-04-20 12:00:00,2,3,6.39,84.46,10.03,2,161,163
2011-04-20 13:00:00,3,2,21.49,25.73,3.63,22,147,169
2011-04-20 14:00:00,3,3,19.01,39.91,2.38,46,130,176
2011-04-20 15:00:00,3,1,32.84,85.53,30.6,32,128,160
2011-04-20 16:00:00,1,4,12.72,84.24,1.81,47,59,106
2011-04-20 17:00:00,4,1,13.1,95.64,36.96,27,96,123
2011-04-20 18:00:00,2,1,17.34,99.8,35.62,21,49,70
2011-04-20 19:00:00,2,1,12.3,98.1,3.98,34,135,169
2011-04-20 20:00:00,3,3,8.88,52.81,45.33,33,145,178
2011-04-20 21:00:00,2,4,30.72,40.03,26.1,29,29,58
2011-04-20 22:00:00,2,2,21.75,80.67,45.22,46,96,142
2011-04-20 23:00:00,4,1,30.84,43.94,45.08,35,149,184
2011-04-21 00:00:00,3,3,29.93,84.51,9.85,13,80,93
2011-04-21 01:00:00,4,2,13.46,62.72,19.03,8,8,16
2011-04-21 02:00:00,1,1,21.43,83.51,6.73,21,21,42
2011-04-21 03:00:00,1,2,7.5,42.07,38.75,27,137,164
2011-04-21 04:00:00,1,1,32.46,60.64,25.21,40,66,106
2011-04-21 05:00:00,3,2,17.13,65.12,46.44,13,8,21
2011-04-21 06:00:00,2,2,16.81,95.45,10.41,14,46,60
2011-04-21 07:00:00,3,4,14.08,41.33,34.42,36,39,75
2011-04-21 08:00:00,3,4,18.82,94.94,49.46,23,35,58
2011-04-21 09:00:00,2,1,12.55,84.39,33.27,33,146,179
2011-04-21 10:00:00,4,3,16.25,78.47,3.44,48,97,145
2011-04-21 11:00:00,1,4,29.0,82.95,29.42,42,1,43
2011-04-21 12:00:00,4,2,30.03,68.43,8.99,44,172,216
2011-04-21 13:00:00,1,4,14.13,39.53,1.53,43,82,125
2011-04-21 14:00:00,3,4,19.07,35.16,16.75,2,160,162
2011-04-21 15:00:00,1,1,31.21,89.31,13.31,22,63,85
2011-04-21 16:00:00,3,4,6.58,78.01,39.44,19,153,172
2011-04-21 17:00:00,4,4,31.67,37.06,18.68,44,118,162
2011-04-21 18:00:00,3,2,11.58,69.21,36.65,14,110,124
2011-04-21 19:00:00,4,4,25.36,55.8,0.81,42,161,203
2011-04-21 20:00:00,2,2,22.48,32.69,0.74,15,190,205
2011-04-21 21:00:00,2,4,21.59,62.55,1.47,6,155,161
2011-04-21 22:00:00,2,4,30.78,42.52,10.97,32,91,123
2011-04-21 23:00:00,3,3,8.05,27.7,18.7,18,77,95
2011-04-22 00:00:00,2,4,15.41,57.36,30.39,17,5,22
2011-04-22 01:00:00,1,2,21.15,67.21,49.3,40,138,178
2011-04-22 02:00:00,4,2,29.34,23.75,17.72,17,45,62
2011-04-22 03:00:00,4,1,11.49,52.17,2.78,2,19,21
2011-04-22 04:00:00,1,1,29.09,40.61,9.75,2,163,165
2011-04-22 05:00:00,3,3,16.99,22.45,44.89,35,112,147
2011-04-22 06:00:00,3,2,10.67,30.05,34.97,15,15,30
2011-04-22 07:00:00,4,2,27.77,31.12,39.51,42,197,239
2011-04-22 08:00:00,2,2,7.73,34.63,6.21,22,199,221
2011-04-22 09:00:00,3,3,20.44,84.27,6.75,22,172,194
2011-04-22 10:00:00,3,2,6.92,55.16,5.61,14,47,61
2011-04-22 11:00:00,1,1,15.69,31.77,42.86,8,112,120
2011-04-22 12:00:00,1,3,23.03,28.02,10.5,39,3,42
2011-04-22 13:00:00,2,1,21.68,43.84,32.16,37,175,212
2011-04-22 14:00:00,3,1,17.14,83.84,25.81,17,97,114
2011-04-22 15:00:00,3,3,17.87,49.16,27.22,37,108,145
2011-04-22 16:00:00,1,4,11.8,32.79,9.77,5,194,199
2011-04-22 17:00:00,3,4,18.68,52.33,31.76,43,155,198
2011-04-22 18:00:00,4,1,33.6,64.42,2.16,36,157,193
2011-04-22 19:00:00,1,4,30.51,22.37,49.67,45,28,73
2011-04-22 20:00:00,2,2,9.36,70.21,1.34,5,148,153
2011-04-22 21:00:00,1,3,5.89,51.61,2.51,20,41,61
2011-04-22 22:00:00,3,1,33.01,20.78,16.23,29,127,156
2011-04-22 23:00:00,2,2,20.8,73.91,41.58,27,49,76
2011-04-23 00:00:00,1,4,21.14,76.99,12.86,19,88,107
2011-04-23 01:00:00,4,2,28.42,70.31,23.6,18,125,143
2011-04-23 02:00:00,4,4,14.44,47.35,0.9,13,2,15
2011-04-23 03:00:00,1,1,19.46,62.37,3.94,0,192,192
2011-04-23 04:00:00,4,2,34.06,50.97,30.4,26,22,48
2011-04-23 05:00:00,4,3,25.16,76.05,9.72,31,106,137
2011-04-23 06:00:00,4,1,9.61,66.69,34.71,28,4,32
2011-04-23 07:00:00,2,2,9.0,26.54,39.27,30,24,54
2011-04-23 08:00:00,4,2,11.13,71.45,42.52,24,34,58
2011-04-23 09:00:00,4,4,28.0,74.98,6.69,6,64,70
2011-04-23 10:00:00,4,1,13.86,49.66,22.78,38,38,76
2011-04-23 11:00:00,2,1,5.64,90.06,47.35,45,122,167
2011-04-23 12:00:00,1,1,33.33,87.44,38.6,15,110,125
2011-04-23 13:00:00,3,1,10.09,34.01,5.85,43,17,60
2011-04-23 14:00:00,4,4,5.29,92.34,25.13,10,24,34
2011-04-23 15:00:00,1,3,12.11,55.27,46.12,17,99,116
2011-04-23 16:00:00,4,1,12.05,77.9,22.0,43,128,171
2011-04-23 17:00:00,2,4,17.66,85.13,41.87,41,189,230
2011-04-23 18:00:00,1,3,32.61,60.41,24.79,4,136,140
2011-04-23 19:00:00,2,3,31.38,51.93,5.34,1,168,169
2011-04-23 20:00:00,4,4,18.71,93.24,7.39,9,94,103
2011-04-23 21:00:00,4,1,17.33,38.47,2.33,25,21,46
2011-04-23 22:00:00,2,3,21.65,40.56,9.77,23,193,216
2011-04-23 23:00:00,3,1,12.3,48.93,44.68,25,172,197
2011-04-24 00:00:00,2,1,6.57,88.76,32.51,15,179,194
2011-04-24 01:00:00,4,2,33.18,95.1,36.94,24,19,43
2011-04-24 02:00:00,2,1,10.6,37.61,31.08,37,120,157
2011-04-24 03:00:00,3,2,10.95,89.11,19.33,5,139,144
2011-04-24 04:00:00,2,3,19.17,40.66,10.84,11,123,134
2011-04-24 05:00:00,3,4,19.75,97.65,46.28,8,63,71
2011-04-24 06:00:00,3,2,5.55,67.79,25.74,48,159,207
2011-04-24 07:00:00,2,4,9.44,20.57,24.05,41,61,102
2011-04-24 08:00:00,2,3,16.34,22.73,49.81,7,132,139
2011-04-24 09:00:00,1,1,25.51,31.8,19.2,30,119,149
2011-04-24 10:00:00,4,3,11.85,35.01,42.71,40,43,83
2011-04-24 11:00:00,3,4,17.69,81.41,43.12,31,156,187
2011-04-24 12:00:00,1,3,21.72,37.82,11.63,6,32,38
2011-04-24 13:00:00,2,1,31.66,97.53,4.74,31,86,117
2011-04-24 14:00:00,4,3,14.78,70.89,48.78,41,99,140
2011-04-24 15:00:00,1,1,9.01,75.4,21.29,24,12,36
2011-04-24 16:00:00,3,2,19.68,37.43,0.11,32,49,81
2011-04-24 17:00:00,1,4,27.4,91.42,24.95,27,129,156
2011-04-24 18:00:00,3,1,8.3,73.43,30.97,10,155,165
2011-04-24 19:00:00,2,1,17.74,89.15,38.8,30,17,47
2011-04-24 20:00:00,4,3,5.53,96.52,47.15,9,65,74
2011-04-24 21:00:00,4,2,6.01,30.05,45.76,1,173,174
2011-04-24 22:00:00,4,1,19.49,27.73,47.01,45,144,189
2011-04-24 23:00:00,2,2,13.95,84.27,1.61,43,160,203
2011-04-25 00:00:00,3,2,30.35,89.29,35.59,3,98,101
2011-04-25 01:00:00,2,3,23.06,66.7,11.29,21,32,53
2011-04-25 02:00:00,4,1,18.62,49.28,9.38,44,95,139
2011-04-25 03:00:00,2,3,17.24,72.21,40.02,27,83,110
2011-04-25 04:00:00,2,4,19.92,44.45,20.86,9,157,166
2011-04-25 05:00:00,2,4,6.21,39.07,45.83,1,21,22
2011-04-25 06:00:00,3,1,31.78,59.05,2.12,48,124,172
2011-04-25 07:00:00,1,2,34.95,37.29,40.11,30,180,210
2011-04-25 08:00:00,1,1,10.44,58.7,6.84,41,173,214
2011-04-25 09:00:00,2,1,8.61,96.53,8.83,22,43,65
2011-04-25 10:00:00,1,4,9.31,87.18,23.87,15,74,89
2011-04-25 11:00:00,1,4,24.83,95.33,19.78,8,113,121
2011-04-25 12:00:00,2,2,24.84,84.51,24.31,42,161,203
2011-04-25 13:00:00,2,2,30.44,48.38,47.0,5,27,32
2011-04-25 14:00:00,4,1,27.55,84.96,32.87,24,162,186
2011-04-25 15:00:00,1,3,18.49,93.83,14.52,3,195,198
2011-04-25 16:00:00,3,1,23.39,95.76,8.65,47,8,55
2011-04-25 17:00:00,2,2,25.65,74.66,21.0,11,106,117
2011-04-25 18:00:00,4,3,20.38,36.91,22.58,23,21,44
2011-04-25 19:00:00,3,4,19.27,23.18,30.06,26,188,214
2011-04-25 20:00:00,1,2,24.35,31.78,13.3,47,84,131
2011-04-25 21:00:00,4,2,21.72,97.24,38.38,2,24,26
2011-04-25 22:00:00,2,3,24.32,56.97,4.92,11,80,91
2011-04-25 23:00:00,3,2,23.39,88.4,28.02,46,78,124
2011-04-26 00:00:00,2,2,26.58,57.2,31.18,29,168,197
2011-04-26 01:00:00,1,2,24.28,72.87,10.34,11,6,17
2011-04-26 02:00:00,3,2,20.59,21.93,41.3,40,58,98
2011-04-26 03:00:00,1,2,25.45,39.99,30.77,41,199,240
2011-04-26 04:00:00,1,2,18.48,54.9,32.29,39,194,233
2011-04-26 05:00:00,4,2,12.25,70.45,24.89,44,32,76
2011-04-26 06:00:00,2,2,5.04,33.72,45.48,21,192,213
2011-04-26 07:00:00,3,4,21.8,81.16,34.7,14,99,113
2011-04-26 08:00:00,1,2,22.72,49.15,19.09,27,103,130
2011-04-26 09:00:00,1,4,34.16,85.39,11.93,16,59,75
2011-04-26 10:00:00,3,4,15.84,27.84,3.55,43,80,123
2011-04-26 11:00:00,1,1,16.82,74.38,8.27,47,121,168
2011-04-26 12:00:00,4,1,11.05,43.47,49.63,24,57,81
2011-04-26 13:00:00,4,4,7.12,83.63,20.34,42,43,85
2011-04-26 14:00:00,4,4,28.18,52.17,44.93,44,120,164
2011-04-26 15:00:00,4,2,12.49,73.23,8.53,2,47,49
2011-04-26 16:00:00,1,1,23.27,94.74,21.27,35,124,159
2011-04-26 17:00:00,3,3,25.63,21.65,48.03,30,164,194
2011-04-26 18:00:00,3,1,19.14,20.89,4.56,14,152,166
2011-04-26 19:00:00,3,4,31.29,81.62,29.7,45,152,197
2011-04-26 20:00:00,3,4,18.31,71.71,45.96,27,56,83
2011-04-26 21:00:00,2,2,13.55,43.44,47.48,42,12,54
2011-04-26 22:00:00,3,2,31.88,59.55,42.3,30,76,106
2011-04-26 23:00:00,2,1,30.85,23.35,42.8,44,11,55
2011-04-27 00:00:00,2,2,9.92,35.4,32.61,19,107,126
2011-04-27 01:00:00,4,3,5.78,53.96,11.02,49,190,239
2011-04-27 02:00:00,2,3,7.7,86.72,36.53,44,189,233
2011-04-27 03:00:00,1,2,13.6,58.37,48.92,20,115,135
2011-04-27 04:00:00,2,3,34.17,66.91,26.3,26,27,53
2011-04-27 05:00:00,4,3,21.76,89.9,13.03,18,182,200
2011-04-27 06:00:00,2,1,16.2,44.71,28.67,35,115,150
2011-04-27 07:00:00,1,3,31.66,76.06,34.53,11,41,52
2011-04-27 08:00:00,1,4,18.59,88.93,10.41,34,188,222
2011-04-27 09:00:00,1,4,14.46,36.21,35.96,47,79,126
2011-04-27 10:00:00,4,1,33.24,48.52,29.37,32,37,69
2011-04-27 11:00:00,4,2,30.49,98.38,30.62,35,80,115
2011-04-27 12:00:00,3,1,30.31,98.66,15.3,40,108,148
2011-04-27 13:00:00,4,2,20.37,37.86,7.76,22,113,135
2011-04-27 14:00:00,1,2,28.68,25.32,31.17,12,107,119
2011-04-27 15:00:00,1,2,10.38,41.67,29.31,29,132,161
2011-04-27 16:00:00,4,2,22.2,51.82,16.9,9,83,92
2011-04-27 17:00:00,2,2,34.52,55.28,14.79,40,175,215
2011-04-27 18:00:00,4,1,13.73,69.5,17.36,19,162,181
2011-04-27 19:00:00,4,2,28.83,91.96,24.49,5,47,52
2011-04-27 20:00:00,1,3,19.71,46.43,48.74,30,13,43
2011-04-27 21:00:00,3,3,6.19,88.0,38.18,18,53,71
2011-04-27 22:00:00,1,2,27.89,27.48,42.59,2,153,155
2011-04-27 23:00:00,3,3,10.06,23.35,25.28,9,117,126
2011-04-28 00:00:00,1,4,23.94,60.32,26.31,9,108,117
2011-04-28 01:00:00,4,1,7.57,24.77,10.22,20,170,190
2011-04-28 02:00:00,1,1,33.41,51.4,36.05,1,41,42
2011-04-28 03:00:00,1,2,13.75,91.74,21.08,44,94,138
2011-04-28 04:00:00,1,2,11.79,39.32,37.12,38,145,183
2011-04-28 05:00:00,4,4,8.87,76.48,20.45,44,102,146
2011-04-28 06:00:00,4,2,33.38,44.19,5.43,29,182,211
2011-04-28 07:00:00,4,3,26.36,23.59,8.65,45,49,94
2011-04-28 08:00:00,4,4,27.25,64.54,40.58,27,124,151
2011-04-28 09:00:00,3,3,19.98,86.79,12.93,17,85,102
2011-04-28 10:00:00,3,1,19.24,52.76,13.22,13,148,161
2011-04-28 11:00:00,2,3,8.3,69.38,46.47,44,161,205
2011-04-28 12:00:00,4,1,21.8,92.0,32.88,18,39,57
2011-04-28 13:00:00,3,3,12.41,83.18,5.72,39,118,157
2011-04-28 14:00:00,1,1,34.31,35.51,7.18,35,110,145
2011-04-28 15:00:00,4,2,28.9,78.67,13.62,40,29,69
2011-04-28 16:00:00,2,3,17.39,60.15,29.7,11,197,208
2011-04-28 17:00:00,2,1,9.54,79.68,37.64,19,116,135
2011-04-28 18:00:00,2,3,28.56,59.56,13.72,33,24,57
2011-04-28 19:00:00,1,4,8.66,30.24,43.53,35,196,231
2011-04-28 20:00:00,3,2,10.68,65.59,5.46,20,28,48
2011-04-28 21:00:00,1,1,11.35,59.37,10.38,18,66,84
2011-04-28 22:00:00,4,4,21.71,61.43,48.52,40,184,224
2011-04-28 23:00:00,2,3,28.61,90.31,6.74,40,46,86
2011-04-29 00:00:00,1,4,14.43,91.59,44.41,42,104,146
2011-04-29 01:00:00,1,3,7.54,56.28,35.2,41,144,185
2011-04-29 02:00:00,3,2,18.94,56.46,3.65,34,176,210
2011-04-29 03:00:00,3,4,27.44,61.21,24.19,7,108,115
2011-04-29 04:00:00,2,2,11.65,61.57,25.95,21,49,70
2011-04-29 05:00:00,1,1,11.6,96.03,46.61,42,89,131
2011-04-29 06:00:00,1,3,33.42,71.95,21.06,37,132,169
2011-04-29 07:00:00,3,3,33.62,42.2,22.34,17,12,29
2011-04-29 08:00:00,1,2,34.71,62.52,5.62,7,190,197
2011-04-29 09:00:00,1,2,29.23,70.18,31.96,1,38,39
2011-04-29 10:00:00,1,1,10.65,71.18,10.54,19,195,214
2011-04-29 11:00:00,3,4,11.36,66.82,3.88,4,172,176
2011-04-29 12:00:00,2,3,15.21,34.22,49.85,41,16,57
2011-04-29 13:00:00,4,3,14.54,22.69,13.48,29,186,215
2011-04-29 14:00:00,2,1,33.7,47.03,7.05,17,98,115
2011-04-29 15:00:00,4,1,28.67,54.2,34.97,43,79,122
2011-04-29 16:00:00,1,2,26.72,24.94,41.08,22,58,80
2011-04-29 17:00:00,2,2,10.58,85.2,3.2,1,95,96
2011-04-29 18:00:00,4,4,32.29,47.53,5.27,41,121,162
2011-04-29 19:00:00,3,1,29.84,93.09,4.51,43,135,178
2011-04-29 20:00:00,3,4,9.91,32.35,2.35,36,29,65
2011-04-29 21:00:00,2,1,31.14,24.55,32.97,41,130,171
2011-04-29 22:00:00,2,3,13.17,58.59,29.42,31,144,175
2011-04-29 23:00:00,1,1,7.43,35.13,33.14,0,122,122
2011-04-30 00:00:00,2,1,24.7,94.99,25.28,38,50,88
2011-04-30 01:00:00,1,3,24.61,20.82,40.88,0,151,151
2011-04-30 02:00:00,1,1,7.85,53.01,27.33,48,79,127
2011-04-30 03:00:00,3,4,14.57,94.14,45.94,43,191,234
2011-04-30 04:00:00,3,2,34.78,50.75,24.28,30,73,103
2011-04-30 05:00:00,4,2,25.35,27.45,39.53,38,122,160
2011-04-30 06:00:00,3,4,26.9,44.23,20.37,7,110,117
2011-04-30 07:00:00,3,3,11.39,59.84,21.76,2,198,200
2011-04-30 08:00:00,2,1,7.36,34.81,42.45,46,111,157
2011-04-30 09:00:00,3,4,13.31,57.32,5.38,11,176,187
2011-04-30 10:00:00,4,2,12.47,86.91,28.25,48,19,67
2011-04-30 11:00:00,2,2,12.04,89.81,36.32,33,28,61
2011-04-30 12:00:00,4,4,10.78,23.94,37.52,48,9,57
2011-04-30 13:00:00,3,2,22.24,32.87,29.57,24,8,32
2011-04-30 14:00:00,4,4,14.84,42.02,22.4,35,198,233
2011-04-30 15:00:00,2,2,29.61,67.59,13.04,6,107,113
2011-04-30 16:00:00,1,4,10.52,48.88,45.47,14,62,76
2011-04-30 17:00:00,4,1,18.94,87.52,18.49,20,32,52
2011-04-30 18:00:00,4,1,5.41,77.33,39.95,24,151,175
2011-04-30 19:00:00,2,1,19.45,28.04,1.58,47,79,126
2011-04-30 20:00:00,2,1,6.68,69.96,11.61,37,31,68
2011-04-30 21:00:00,4,2,34.33,29.04,17.28,36,3,39
2011-04-30 22:00:00,3,3,28.72,40.4,33.58,15,189,204
2011-04-30 23:00:00,4,4,19.7,34.23,15.97,0,77,77
2011-05-01 00:00:00,2,3,7.6,33.84,2.07,46,125,171
2011-05-01 01:00:00,1,2,22.77,69.31,8.69,36,118,154
2011-05-01 02:00:00,1,2,27.76,65.09,12.96,44,21,65
2011-05-01 03:00:00,3,3,10.72,34.08,8.8,13,150,163
2011-05-01 04:00:00,4,3,22.05,99.21,10.19,33,25,58
2011-05-01 05:00:00,1,2,29.43,53.75,38.45,1,48,49
2011-05-01 06:00:00,4,2,28.05,27.77,20.6,30,171,201
2011-05-01 07:00:00,2,4,29.09,29.65,20.26,18,149,167
2011-05-01 08:00:00,1,1,31.38,66.71,48.33,18,107,125
2011-05-01 09:00:00,3,1,33.13,98.33,22.34,43,194,237
2011-05-01 10:00:00,2,4,17.17,65.76,46.38,22,169,191
2011-05-01 11:00:00,3,3,22.06,95.92,14.95,29,51,80
2011-05-01 12:00:00,2,2,28.72,55.53,20.03,16,144,160
2011-05-01 13:00:00,1,3,25.91,54.87,19.81,1,141,142
2011-05-01 14:00:00,3,1,34.87,60.0,27.3,10,63,73
2011-05-01 15:00:00,3,1,5.41,75.79,29.21,48,172,220
2011-05-01 16:00:00,2,3,15.65,49.41,12.41,13,191,204
2011-05-01 17:00:00,3,1,13.43,89.11,39.68,40,157,197
2011-05-01 18:00:00,2,2,12.87,22.34,24.83,28,140,168
2011-05-01 19:00:00,2,4,11.68,55.18,0.35,18,153,171
2011-05-01 20:00:00,2,3,26.27,60.88,29.57,27,159,186
2011-05-01 21:00:00,2,2,7.54,68.56,39.9,0,173,173
2011-05-01 22:00:00,1,2,27.25,42.09,12.52,4,50,54
2011-05-01 23:00:00,2,1,25.8,54.2,1.89,33,33,66
2011-05-02 00:00:00,4,2,12.52,58.76,40.36,13,107,120
2011-05-02 01:00:00,3,3,12.59,74.95,48.81,18,115,133
2011-05-02 02:00:00,4,2,23.87,81.88,3.83,23,27,50
2011-05-02 03:00:00,1,4,27.87,79.03,46.9,39,18,57
2011-05-02 04:00:00,4,2,31.29,47.33,17.96,16,175,191
2011-05-02 05:00:00,3,2,30.56,99.96,47.07,1,97,98
2011-05-02 06:00:00,4,4,33.95,87.89,32.44,30,71,101
2011-05-02 07:00:00,1,2,22.44,40.8,44.51,16,161,177
2011-05-02 08:00:00,2,2,32.26,35.61,39.29,7,105,112
2011-05-02 09:00:00,4,1,29.26,45.12,1.4,45,143,188
2011-05-02 10:00:00,1,3,31.84,56.19,3.27,16,70,86
2011-05-02 11:00:00,1,1,5.35,88.06,26.29,37,26,63
2011-05-02 12:00:00,3,3,33.98,82.27,6.48,25,50,75
2011-05-02 13:00:00,3,4,19.21,88.1,23.05,42,83,125
2011-05-02 14:00:00,4,4,28.95,41.76,47.73,39,53,92
2011-05-02 15:00:00,2,4,8.82,67.48,14.74,44,122,166
2011-05-02 16:00:00,1,3,16.88,42.66,24.45,39,16,55
2011-05-02 17:00:00,4,3,13.14,28.72,19.21,6,71,77
2011-05-02 18:00:00,1,3,13.75,74.74,31.49,23,195,218
2011-05-02 19:00:00,1,4,8.7,31.44,9.69,29,113,142
2011-05-02 20:00:00,2,3,29.17,73.42,13.0,25,94,119
2011-05-02 21:00:00,2,2,5.28,71.84,42.94,29,128,157
2011-05-02 22:00:00,4,1,14.38,84.82,40.57,34,104,138
2011-05-02 23:00:00,2,4,10.23,31.16,39.46,1,13,14
2011-05-03 00:00:00,2,1,22.67,82.68,38.55,43,134,177
2011-05-03 01:00:00,4,2,12.63,99.94,22.97,3,63,66
2011-05-03 02:00:00,2,3,12.77,88.08,36.44,4,199,203
2011-05-03 03:00:00,3,1,19.65,80.14,19.36,47,135,182
2011-05-03 04:00:00,1,2,24.58,72.97,5.04,1,181,182
2011-05-03 05:00:00,1,2,8.64,53.74,19.67,30,151,181
2011-05-03 06:00:00,1,1,10.27,78.44,7.93,26,182,208
2011-05-03 07:00:00,1,4,12.42,77.93,19.54,23,128,151
2011-05-03 08:00:00,4,1,34.21,70.52,14.87,44,199,243
2011-05-03 09:00:00,1,4,16.91,83.7,29.96,3,68,71
2011-05-03 10:00:00,1,3,22.97,55.9,18.08,27,31,58
2011-05-03 11:00:00,1,4,12.25,29.7,35.28,4,0,4
2011-05-03 12:00:00,1,3,19.71,64.73,25.61,26,193,219
2011-05-03 13:00:00,3,1,7.22,41.2,45.97,43,169,212
2011-05-03 14:00:00,1,3,6.04,50.75,4.55,46,136,182
2011-05-03 15:00:00,3,2,19.06,21.39,34.39,4,73,77
2011-05-03 16:00:00,4,3,16.96,50.62,33.62,4,151,155
2011-05-03 17:00:00,2,4,9.11,84.7,47.53,47,104,151
2011-05-03 18:00:00,1,4,25.63,63.42,18.58,8,113,121
2011-05-03 19:00:00,2,4,34.79,20.78,15.27,46,146,192
2011-05-03 20:00:00,2,3,16.87,57.59,8.62,26,50,76
2011-05-03 21:00:00,4,4,23.74,43.32,13.26,3,80,83
2011-05-03 22:00:00,2,4,33.89,58.2,25.09,48,1,49
2011-05-03 23:00:00,3,2,29.95,52.38,41.89,23,9,32
2011-05-04 00:00:00,2,3,18.91,94.56,14.21,26,196,222
2011-05-04 01:00:00,2,2,27.12,23.29,7.89,0,102,102
2011-05-04 02:00:00,2,4,8.84,74.69,13.61,31,133,164
2011-05-04 03:00:00,1,4,20.36,88.08,5.05,15,189,204
2011-05-04 04:00:00,1,4,13.37,96.74,46.33,22,65,87
2011-05-04 05:00:00,3,3,9.83,34.21,43.63,27,7,34
2011-05-04 06:00:00,3,1,17.79,62.5,15.42,19,67,86
2011-05-04 07:00:00,1,4,8.93,23.49,12.35,16,186,202
2011-05-04 08:00:00,3,4,25.97,59.93,45.27,35,49,84
2011-05-04 09:00:00,1,4,18.69,30.04,0.09,44,94,138
2011-05-04 10:00:00,4,4,20.93,87.03,30.03,7,35,42
2011-05-04 11:00:00,2,3,9.39,29.11,45.8,17,135,152
2011-05-04 12:00:00,2,1,9.19,61.06,25.43,12,94,106
2011-05-04 13:00:00,3,1,22.5,61.69,0.15,8,144,152
2011-05-04 14:00:00,1,1,34.55,97.73,10.94,36,186,222
2011-05-04 15:00:00,1,4,7.89,72.4,46.12,29,77,106
2011-05-04 16:00:00,3,4,13.57,43.03,0.85,42,135,177
2011-05-04 17:00:00,1,1,31.08,39.26,19.74,27,121,148
2011-05-04 18:00:00,4,1,7.17,30.26,39.49,45,88,133
2011-05-04 19:00:00,2,4,31.28,80.52,41.9,49,42,91
2011-05-04 20:00:00,3,4,20.73,75.26,23.88,17,62,79
2011-05-04 21:00:00,3,2,17.25,68.79,11.62,19,80,99
2011-05-04 22:00:00,1,2,14.29,23.27,29.99,47,112,159
2011-05-04 23:00:00,3,2,13.91,81.03,13.19,35,11,46
2011-05-05 00:00:00,4,1,14.17,71.35,12.76,18,83,101
2011-05-05 01:00:00,1,3,31.54,97.11,40.38,4,97,101
2011-05-05 02:00:00,1,4,26.71,66.98,7.71,33,55,88
2011-05-05 03:00:00,1,2,25.09,44.32,0.28,16,48,64
2011-05-05 04:00:00,1,3,28.96,50.52,16.84,27,179,206
2011-05-05 05:00:00,4,4,12.71,34.07,24.55,35,138,173
2011-05-05 06:00:00,1,3,23.54,77.83,35.25,37,26,63
2011-05-05 07:00:00,3,1,18.8,76.62,39.06,29,189,218
2011-05-05 08:00:00,4,1,28.47,36.05,33.18,17,136,153
2011-05-05 09:00:00,2,1,14.28,32.68,31.33,5,81,86
2011-05-05 10:00:00,2,2,24.3,26.16,33.29,25,35,60
2011-05-05 11:00:00,3,4,31.47,92.96,13.58,14,173,187
2011-05-05 12:00:00,3,1,17.06,38.65,19.12,0,117,117
2011-05-05 13:00:00,4,2,7.0,47.53,30.82,16,156,172
2011-05-05 14:00:00,2,2,20.48,42.44,3.28,30,195,225
2011-05-05 15:00:00,2,2,15.38,53.09,14.77,1,78,79
2011-05-05 16:00:00,2,2,25.17,77.12,20.32,35,40,75
2011-05-05 17:00:00,2,1,33.53,89.65,26.67,34,27,61
2011-05-05 18:00:00,2,2,19.57,34.61,24.32,26,191,217
2011-05-05 19:00:00,1,1,18.99,74.91,35.91,2,151,153
2011-05-05 20:00:00,3,1,24.64,48.2,23.67,45,100,145
2011-05-05 21:00:00,1,2,8.1,98.44,45.21,19,143,162
2011-05-05 22:00:00,2,1,12.61,43.91,19.02,7,21,28
2011-05-05 23:00:00,4,4,32.57,20.58,26.27,28,46,74
2011-05-06 00:00:00,4,4,25.1,61.25,0.16,7,16,23
2011-05-06 01:00:00,2,3,5.4,32.06,15.52,40,128,168
2011-05-06 02:00:00,2,4,11.14,23.56,43.33,49,158,207
2011-05-06 03:00:00,4,1,25.49,75.86,16.68,26,88,114
2011-05-06 04:00:00,1,1,27.93,78.58,12.66,25,11,36
2011-05-06 05:00:00,1,4,30.2,56.86,27.18,38,19,57
2011-05-06 06:00:00,2,2,13.77,74.15,3.94,9,146,155
2011-05-06 07:00:00,1,2,32.93,63.06,26.58,29,4,33
2011-05-06 08:00:00,4,1,21.59,70.38,15.18,32,14,46
2011-05-06 09:00:00,1,2,25.9,67.74,19.16,35,24,59
2011-05-06 10:00:00,2,3,22.9,73.27,39.57,19,162,181
2011-05-06 11:00:00,4,3,8.68,35.97,33.1,3,107,110
2011-05-06 12:00:00,1,4,33.89,41.5,22.31,22,54,76
2011-05-06 13:00:00,3,4,8.69,55.2,28.88,28,62,90
2011-05-06 14:00:00,4,2,12.65,55.69,38.34,45,46,91
2011-05-06 15:00:00,4,1,29.41,81.95,37.29,31,194,225
2011-05-06 16:00:00,3,4,23.56,49.39,9.27,36,115,151
2011-05-06 17:00:00,3,3,30.14,33.0,15.05,36,63,99
2011-05-06 18:00:00,4,4,20.47,40.12,17.41,25,21,46
2011-05-06 19:00:00,3,4,16.31,37.18,9.38,4,196,200
2011-05-06 20:00:00,2,3,32.66,78.53,0.61,23,105,128
2011-05-06 21:00:00,2,1,6.09,57.63,8.7,42,76,118
2011-05-06 22:00:00,2,4,30.68,76.69,40.41,1,73,74
2011-05-06 23:00:00,4,4,11.92,53.3,27.3,14,79,93
2011-05-07 00:00:00,3,4,30.46,91.18,17.08,45,126,171
2011-05-07 01:00:00,3,2,9.18,98.68,30.42,45,129,174
2011-05-07 02:00:00,1,4,22.41,73.59,36.99,39,125,164
2011-05-07 03:00:00,1,3,31.64,89.11,17.72,7,113,120
2011-05-07 04:00:00,3,1,19.21,60.63,23.3,36,114,150
2011-05-07 05:00:00,3,1,27.4,94.77,3.21,36,152,188
2011-05-07 06:00:00,3,3,29.14,86.53,29.85,13,60,73
2011-05-07 07:00:00,4,2,27.09,99.34,17.82,4,4,8
2011-05-07 08:00:00,3,3,32.76,69.85,21.68,8,27,35
2011-05-07 09:00:00,1,1,18.41,82.34,21.13,21,80,101
2011-05-07 10:00:00,4,3,10.19,63.43,31.62,42,193,235
2011-05-07 11:00:00,3,2,6.43,40.73,28.62,48,14,62
2011-05-07 12:00:00,1,1,12.39,48.38,21.11,43,182,225
2011-05-07 13:00:00,4,2,9.3,91.52,0.85,43,119,162
2011-05-07 14:00:00,3,3,21.74,24.48,31.05,47,37,84
2011-05-07 15:00:00,3,4,10.55,67.32,43.98,29,150,179
2011-05-07 16:00:00,3,3,6.17,49.8,38.48,32,13,45
2011-05-07 17:00:00,4,2,6.08,50.94,49.08,49,31,80
2011-05-07 18:00:00,1,3,29.95,90.77,6.95,37,43,80
2011-05-07 19:00:00,1,4,22.74,88.31,11.13,36,197,233
2011-05-07 20:00:00,2,2,15.74,67.91,26.96,49,91,140
2011-05-07 21:00:00,3,3,31.83,41.83,11.79,44,117,161
2011-05-07 22:00:00,2,2,7.11,58.04,1.73,37,115,152
2011-05-07 23:00:00,2,2,34.41,52.66,20.11,6,122,128
2011-05-08 00:00:00,1,1,23.49,48.29,14.38,2,115,117
2011-05-08 01:00:00,4,1,10.5,28.22,13.19,42,185,227
2011-05-08 02:00:00,4,2,25.37,63.45,47.66,39,101,140
2011-05-08 03:00:00,1,3,27.9,44.15,11.92,31,3,34
2011-05-08 04:00:00,4,3,17.88,72.86,6.47,35,114,149
2011-05-08 05:00:00,2,3,30.85,45.54,6.27,41,189,230
2011-05-08 06:00:00,3,4,9.52,54.49,40.32,40,187,227
2011-05-08 07:00:00,1,2,13.37,24.19,35.74,44,58,102
2011-05-08 08:00:00,3,2,7.8,99.4,6.47,18,74,92
2011-05-08 09:00:00,4,4,11.33,60.61,10.99,30,156,186
2011-05-08 10:00:00,3,2,12.16,21.94,37.37,29,146,175
2011-05-08 11:00:00,4,2,32.53,63.3,13.73,46,144,190
2011-05-08 12:00:00,4,4,7.34,89.63,49.08,36,3,39
2011-05-08 13:00:00,2,1,17.82,81.8,27.03,24,171,195
2011-05-08 14:00:00,4,2,20.97,76.07,9.6,12,3,15
2011-05-08 15:00:00,2,4,31.96,31.16,42.94,11,186,197
2011-05-08 16:00:00,2,3,34.93,72.62,15.97,8,139,147
2011-05-08 17:00:00,2,1,27.6,81.3,14.44,39,46,85
2011-05-08 18:00:00,1,3,34.12,65.79,16.37,8,134,142
2011-05-08 19:00:00,1,2,28.61,91.42,38.41,44,139,183
2011-05-08 20:00:00,4,1,33.9,42.16,8.66,26,70,96
2011-05-08 21:00:00,2,4,26.22,39.37,19.09,40,53,93
2011-05-08 22:00:00,1,2,7.39,89.57,1.54,30,185,215
2011-05-08 23:00:00,2,4,17.06,70.03,41.33,5,62,67
2011-05-09 00:00:00,3,1,24.4,20.12,17.04,28,142,170
2011-05-09 01:00:00,3,3,15.52,48.25,12.41,29,164,193
2011-05-09 02:00:00,3,2,13.2,88.63,28.99,37,55,92
2011-05-09 03:00:00,4,2,22.32,22.19,35.25,10,72,82
2011-05-09 04:00:00,2,4,33.01,20.26,40.64,41,96,137
2011-05-09 05:00:00,3,1,6.05,42.5,17.39,45,101,146
2011-05-09 06:00:00,1,4,28.08,93.12,40.62,5,79,84
2011-05-09 07:00:00,3,1,26.68,92.12,23.24,38,30,68
2011-05-09 08:00:00,3,2,33.92,61.5,5.06,40,14,54
2011-05-09 09:00:00,3,1,32.92,64.26,42.32,30,129,159
2011-05-09 10:00:00,4,2,27.87,46.56,27.38,34,12,46
2011-05-09 11:00:00,1,1,20.61,39.5,30.12,11,4,15
2011-05-09 12:00:00,2,3,11.13,85.22,46.87,47,175,222
2011-05-09 13:00:00,1,1,21.36,28.5,27.96,44,160,204
2011-05-09 14:00:00,2,3,27.96,58.99,0.28,5,31,36
2011-05-09 15:00:00,4,1,31.87,70.75,43.53,44,180,224
2011-05-09 16:00:00,4,1,28.69,28.29,14.24,25,105,130
2011-05-09 17:00:00,4,4,10.86,61.57,25.09,36,20,56
2011-05-09 18:00:00,4,4,22.99,66.2,10.24,31,193,224
2011-05-09 19:00:00,2,2,14.97,79.4,14.85,3,188,191
2011-05-09 20:00:00,3,4,5.28,38.79,34.33,39,181,220
2011-05-09 21:00:00,2,1,11.01,43.47,21.48,2,40,42
2011-05-09 22:00:00,1,4,8.4,65.56,31.36,1,86,87
2011-05-09 23:00:00,4,1,30.28,98.65,41.18,19,165,184
2011-05-10 00:00:00,4,3,12.76,37.4,17.04,18,160,178
2011-05-10 01:00:00,1,1,13.54,98.87,28.42,38,135,173
2011-05-10 02:00:00,2,2,33.8,77.15,38.88,11,35,46
2011-05-10 03:00:00,3,3,16.37,86.09,35.76,35,32,67
2011-05-10 04:00:00,3,2,5.29,27.17,26.99,41,28,69
2011-05-10 05:00:00,1,2,13.52,44.03,19.17,27,94,121
2011-05-10 06:00:00,3,2,8.58,24.62,20.38,8,56,64
2011-05-10 07:00:00,2,4,8.08,49.72,21.66,43,71,114
2011-05-10 08:00:00,2,2,7.32,98.5,17.44,10,188,198
2011-05-10 09:00:00,1,3,22.8,28.42,34.95,29,89,118
2011-05-10 10:00:00,2,1,10.68,64.99,6.27,1,113,114
2011-05-10 11:00:00,4,2,15.84,20.49,48.37,37,182,219
2011-05-10 12:00:00,1,3,30.86,77.01,38.95,37,179,216
2011-05-10 13:00:00,2,2,17.73,35.78,14.91,32,114,146
2011-05-10 14:00:00,1,1,32.47,30.37,2.13,6,170,176
2011-05-10 15:00:00,3,3,19.94,46.96,35.57,43,125,168
2011-05-10 16:00:00,2,3,16.97,81.68,36.72,20,123,143
2011-05-10 17:00:00,4,1,27.51,28.53,48.18,11,153,164
2011-05-10 18:00:00,2,3,7.2,38.39,12.69,20,115,135
2011-05-10 19:00:00,1,1,7.68,20.68,4.14,22,102,124
2011-05-10 20:00:00,1,3,24.56,97.47,45.76,5,1,6
2011-05-10 21:00:00,2,3,19.61,67.37,12.93,13,182,195
2011-05-10 22:00:00,4,1,28.71,77.59,36.08,31,89,120
2011-05-10 23:00:00,4,1,32.49,72.11,3.03,48,17,65
2011-05-11 00:00:00,4,3,16.65,31.55,38.03,48,177,225
2011-05-11 01:00:00,1,3,22.89,67.6,6.35,49,44,93
2011-05-11 02:00:00,2,1,20.02,30.51,34.78,44,14,58
2011-05-11 03:00:00,3,4,34.45,52.1,26.62,12,134,146
2011-05-11 04:00:00,1,1,29.93,65.52,47.77,26,154,180
2011-05-11 05:00:00,4,3,32.35,64.71,1.85,10,39,49
2011-05-11 06:00:00,2,3,12.63,29.53,14.6,31,16,47
2011-05-11 07:00:00,4,3,28.18,22.75,3.48,2,159,161
2011-05-11 08:00:00,3,1,12.96,83.86,43.96,48,143,191
2011-05-11 09:00:00,4,3,11.26,78.07,29.7,1,190,191
2011-05-11 10:00:00,4,4,33.33,26.55,26.75,29,77,106
2011-05-11 11:00:00,3,2,5.58,30.19,6.57,1,187,188
2011-05-11 12:00:00,2,4,33.96,91.41,24.45,38,104,142
2011-05-11 13:00:00,1,1,9.48,81.53,19.94,28,81,109
2011-05-11 14:00:00,2,3,29.58,99.69,15.79,21,85,106
2011-05-11 15:00:00,3,1,13.28,40.32,38.61,24,179,203
2011-05-11 16:00:00,4,2,15.52,59.02,3.06,41,79,120
2011-05-11 17:00:00,2,1,11.5,38.92,32.33,45,48,93
2011-05-11 18:00:00,1,3,22.57,69.82,41.15,18,48,66
2011-05-11 19:00:00,3,2,15.44,29.23,45.37,48,153,201
2011-05-11 20:00:00,2,2,24.72,30.18,37.3,15,178,193
2011-05-11 21:00:00,1,3,5.47,25.75,14.12,16,42,58
2011-05-11 22:00:00,3,3,6.93,75.49,30.03,49,69,118
2011-05-11 23:00:00,1,3,7.99,59.53,7.07,26,70,96
2011-05-12 00:00:00,3,1,17.57,69.42,5.85,42,8,50
2011-05-12 01:00:00,4,4,29.44,90.34,31.93,18,171,189
2011-05-12 02:00:00,2,1,31.65,79.23,42.56,42,191,233
2011-05-12 03:00:00,1,1,12.34,56.94,3.36,41,89,130
2011-05-12 04:00:00,3,4,22.23,98.75,5.3,29,1,30
2011-05-12 05:00:00,1,3,28.05,56.5,28.28,13,163,176
2011-05-12 06:00:00,1,3,13.66,29.0,10.91,45,2,47
2011-05-12 07:00:00,2,4,17.27,99.41,30.59,41,181,222
2011-05-12 08:00:00,4,4,20.72,21.83,10.73,31,148,179
2011-05-12 09:00:00,1,1,9.05,63.99,5.82,22,194,216
2011-05-12 10:00:00,3,2,5.78,44.73,27.28,35,8,43
2011-05-12 11:00:00,3,4,9.58,60.28,43.11,9,11,20
2011-05-12 12:00:00,4,1,23.81,64.7,34.26,37,199,236
2011-05-12 13:00:00,3,2,7.21,39.21,40.94,28,164,192
2011-05-12 14:00:00,4,3,10.69,64.55,13.32,10,164,174
2011-05-12 15:00:00,3,3,15.14,80.48,44.3,49,103,152
2011-05-12 16:00:00,2,1,7.34,41.32,18.85,37,194,231
2011-05-12 17:00:00,1,1,10.75,50.67,42.62,14,55,69
2011-05-12 18:00:00,2,4,32.34,41.46,23.56,31,104,135
2011-05-12 19:00:00,1,3,5.58,85.64,13.39,26,62,88
2011-05-12 20:00:00,1,1,24.6,78.0,13.01,37,153,190
2011-05-12 21:00:00,1,3,16.53,89.7,28.38,0,45,45
2011-05-12 22:00:00,2,3,25.18,33.6,3.95,40,180,220
2011-05-12 23:00:00,1,4,22.66,25.89,46.5,13,59,72
2011-05-13 00:00:00,2,2,11.7,29.55,13.57,2,31,33
2011-05-13 01:00:00,4,4,30.42,32.88,16.78,29,90,119
2011-05-13 02:00:00,3,1,19.76,62.65,11.67,30,189,219
2011-05-13 03:00:00,3,4,29.68,97.67,0.15,0,174,174
2011-05-13 04:00:00,1,4,17.18,48.58,34.63,45,60,105
2011-05-13 05:00:00,2,3,34.54,96.68,29.53,13,93,106
2011-05-13 06:00:00,3,4,28.11,23.06,40.48,35,131,166
2011-05-13 07:00:00,2,1,33.98,94.15,2.05,45,129,174
2011-05-13 08:00:00,2,2,20.43,34.49,46.43,35,150,185
2011-05-13 09:00:00,1,4,19.21,93.0,16.54,42,54,96
2011-05-13 10:00:00,3,4,27.66,24.5,45.65,40,40,80
2011-05-13 11:00:00,1,2,31.41,95.86,5.36,42,195,237
2011-05-13 12:00:00,1,1,33.92,36.06,37.2,14,164,178
2011-05-13 13:00:00,3,1,14.74,44.22,28.97,37,138,175
2011-05-13 14:00:00,3,4,28.96,59.28,17.91,24,163,187
2011-05-13 15:00:00,4,3,11.32,50.46,3.96,43,14,57
2011-05-13 16:00:00,4,4,21.37,73.4,30.24,44,100,144
2011-05-13 17:00:00,2,2,10.4,97.98,1.32,49,66,115
2011-05-13 18:00:00,3,2,15.42,68.51,25.06,13,111,124
2011-05-13 19:00:00,4,2,32.94,77.72,30.21,23,157,180
2011-05-13 20:00:00,2,4,9.38,27.04,36.63,42,56,98
2011-05-13 21:00:00,2,4,23.97,70.22,49.57,1,189,190
2011-05-13 22:00:00,2,1,22.79,56.31,13.0,33,32,65
2011-05-13 23:00:00,4,3,8.62,90.86,16.12,48,64,112
2011-05-14 00:00:00,3,4,14.78,51.06,17.06,22,0,22
2011-05-14 01:00:00,1,1,21.89,74.36,36.58,7,130,137
2011-05-14 02:00:00,2,4,10.62,38.25,46.59,4,8,12
2011-05-14 03:00:00,4,1,29.02,40.75,48.72,28,31,59
2011-05-14 04:00:00,4,1,34.16,50.09,47.29,42,76,118
2011-05-14 05:00:00,1,3,11.44,44.33,43.97,32,44,76
2011-05-14 06:00:00,1,4,10.61,40.31,49.55,19,94,113
2011-05-14 07:00:00,4,1,18.65,23.97,18.8,15,184,199
2011-05-14 08:00:00,3,2,27.43,86.94,47.42,36,20,56
2011-05-14 09:00:00,1,2,13.45,25.14,38.05,47,22,69
2011-05-14 10:00:00,4,2,5.6,90.99,8.42,36,153,189
2011-05-14 11:00:00,1,3,21.24,30.04,2.27,41,116,157
2011-05-14 12:00:00,3,1,33.7,25.22,10.72,40,199,239
2011-05-14 13:00:00,2,3,16.74,65.04,38.94,23,103,126
2011-05-14 14:00:00,1,4,17.6,60.2,31.58,28,29,57
2011-05-14 15:00:00,3,4,34.07,59.3,11.22,34,114,148
2011-05-14 16:00:00,4,1,25.84,65.96,37.1,8,68,76
2011-05-14 17:00:00,1,2,26.58,42.96,7.07,21,151,172
2011-05-14 18:00:00,1,1,21.88,73.04,41.09,19,73,92
2011-05-14 19:00:00,4,1,34.24,60.19,39.71,39,63,102
2011-05-14 20:00:00,2,1,25.67,46.78,48.63,3,162,165
2011-05-14 21:00:00,4,3,31.85,86.12,7.51,42,149,191
2011-05-14 22:00:00,1,4,25.98,78.22,45.33,35,38,73
2011-05-14 23:00:00,4,1,27.05,51.49,17.06,11,54,65
2011-05-15 00:00:00,3,1,13.71,87.81,20.8,22,6,28
2011-05-15 01:00:00,4,1,14.1,93.62,23.42,38,189,227
2011-05-15 02:00:00,1,3,28.49,62.95,31.35,7,38,45
2011-05-15 03:00:00,4,3,13.9,37.2,49.74,9,147,156
2011-05-15 04:00:00,2,3,21.88,93.26,30.0,22,103,125
2011-05-15 05:00:00,4,1,12.48,35.16,46.34,28,183,211
2011-05-15 06:00:00,2,2,29.51,23.87,12.75,44,95,139
2011-05-15 07:00:00,3,2,8.32,46.2,19.92,31,193,224
2011-05-15 08:00:00,2,2,29.88,78.16,25.22,13,142,155
2011-05-15 09:00:00,4,4,23.08,93.86,16.15,15,148,163
2011-05-15 10:00:00,1,1,10.61,70.98,48.84,38,33,71
2011-05-15 11:00:00,2,2,21.26,96.15,36.28,47,34,81
2011-05-15 12:00:00,3,2,13.47,27.39,23.94,16,114,130
2011-05-15 13:00:00,2,2,14.7,24.86,37.57,19,4,23
2011-05-15 14:00:00,2,1,15.55,68.34,23.37,11,55,66
2011-05-15 15:00:00,2,2,6.9,97.29,0.86,8,82,90
2011-05-15 16:00:00,3,2,34.58,60.22,27.16,7,6,13
2011-05-15 17:00:00,4,1,5.95,24.12,31.26,40,52,92
2011-05-15 18:00:00,2,4,24.87,37.7,49.06,36,171,207
2011-05-15 19:00:00,2,3,16.14,39.58,2.04,20,185,205
2011-05-15 20:00:00,1,2,24.38,47.03,25.6,41,105,146
2011-05-15 21:00:00,3,3,15.69,23.49,4.91,31,41,72
2011-05-15 22:00:00,2,4,25.21,92.39,7.45,36,17,53
2011-05-15 23:00:00,3,4,26.88,61.25,30.52,45,5,50
2011-05-16 00:00:00,2,2,25.72,73.67,11.58,17,131,148
2011-05-16 01:00:00,4,1,8.42,25.37,37.46,28,196,224
2011-05-16 02:00:00,4,4,24.71,24.33,25.71,6,141,147
2011-05-16 03:00:00,2,3,13.4,66.92,10.91,39,168,207
2011-05-16 04:00:00,4,3,5.86,90.98,24.69,36,174,210
2011-05-16 05:00:00,2,3,17.44,62.28,0.04,5,96,101
2011-05-16 06:00:00,4,3,18.01,90.23,43.14,19,52,71
2011-05-16 07:00:00,1,4,19.02,84.88,0.63,8,20,28
2011-05-16 08:00:00,1,2,26.14,26.07,0.35,8,140,148
2011-05-16 09:00:00,1,2,14.27,36.16,30.58,7,193,200
2011-05-16 10:00:00,3,3,14.46,72.62,48.68,16,142,158
2011-05-16 11:00:00,3,2,6.82,55.48,42.8,23,98,121
2011-05-16 12:00:00,1,3,25.6,43.26,12.6,39,172,211
2011-05-16 13:00:00,3,3,22.03,53.49,9.83,22,83,105
2011-05-16 14:00:00,4,1,15.48,55.62,31.31,32,192,224
2011-05-16 15:00:00,2,4,26.16,92.84,41.13,21,173,194
2011-05-16 16:00:00,2,4,21.12,28.28,18.1,49,130,179
2011-05-16 17:00:00,2,3,19.08,42.38,21.62,46,144,190
2011-05-16 18:00:00,1,4,20.34,63.01,5.77,21,144,165
2011-05-16 19:00:00,3,2,24.09,75.86,7.64,26,19,45
2011-05-16 20:00:00,4,3,24.8,70.45,28.42,47,3,50
2011-05-16 21:00:00,4,1,13.67,95.33,5.13,1,74,75
2011-05-16 22:00:00,1,2,9.22,83.65,10.1,30,14,44
2011-05-16 23:00:00,4,1,9.7,64.57,11.73,12,56,68
2011-05-17 00:00:00,4,1,24.18,37.17,22.2,1,172,173
2011-05-17 01:00:00,4,4,31.19,56.07,2.28,45,26,71
2011-05-17 02:00:00,4,4,17.28,75.47,24.99,6,19,25
2011-05-17 03:00:00,3,3,10.09,87.04,46.43,10,107,117
2011-05-17 04:00:00,4,4,27.7,96.78,1.22,46,78,124
2011-05-17 05:00:00,2,1,29.97,68.44,31.55,25,133,158
2011-05-17 06:00:00,1,1,31.42,62.15,41.79,48,17,65
2011-05-17 07:00:00,3,2,23.2,21.42,15.62,20,85,105
2011-05-17 08:00:00,4,1,30.82,25.77,6.58,48,48,96
2011-05-17 09:00:00,3,3,5.46,32.49,2.17,14,151,165
2011-05-17 10:00:00,4,3,8.22,24.38,32.2,15,10,25
2011-05-17 11:00:00,2,4,7.78,52.07,27.61,8,145,153
2011-05-17 12:00:00,1,4,26.38,46.95,11.46,20,34,54
2011-05-17 13:00:00,4,4,7.09,70.99,41.58,40,54,94
2011-05-17 14:00:00,4,3,19.89,62.85,36.78,5,94,99
2011-05-17 15:00:00,4,1,19.18,67.68,13.82,0,27,27
2011-05-17 16:00:00,4,4,14.32,57.76,37.67,30,87,117
2011-05-17 17:00:00,1,2,31.11,42.22,12.25,4,163,167
2011-05-17 18:00:00,1,4,10.11,96.23,33.76,36,108,144
2011-05-17 19:00:00,2,3,15.57,26.91,5.93,25,23,48
2011-05-17 20:00:00,1,4,28.23,95.11,34.61,0,160,160
2011-05-17 21:00:00,4,1,5.91,44.9,11.94,0,115,115
2011-05-17 22:00:00,2,4,25.19,61.01,28.62,28,164,192
2011-05-17 23:00:00,2,3,29.49,28.71,8.62,21,140,161
2011-05-18 00:00:00,2,3,32.97,25.67,36.3,37,15,52
2011-05-18 01:00:00,4,2,31.29,54.36,3.04,40,111,151
2011-05-18 02:00:00,3,3,14.58,79.34,8.27,18,170,188
2011-05-18 03:00:00,4,2,22.59,41.55,9.21,27,72,99
2011-05-18 04:00:00,1,1,7.32,64.99,2.07,4,49,53
2011-05-18 05:00:00,1,3,12.74,42.29,37.25,20,110,130
2011-05-18 06:00:00,4,4,7.83,51.09,49.05,48,12,60
2011-05-18 07:00:00,4,1,14.46,92.52,38.92,21,70,91
2011-05-18 08:00:00,2,4,31.26,88.47,43.03,19,162,181
2011-05-18 09:00:00,4,4,15.42,61.28,0.3,11,34,45
2011-05-18 10:00:00,2,4,21.86,39.05,5.89,5,23,28
2011-05-18 11:00:00,1,1,18.0,35.45,27.95,28,180,208
2011-05-18 12:00:00,2,1,18.77,96.33,48.89,44,38,82
2011-05-18 13:00:00,4,3,34.09,36.22,33.04,39,146,185
2011-05-18 14:00:00,1,4,13.88,84.65,18.71,34,171,205
2011-05-18 15:00:00,3,2,23.82,49.52,7.31,10,125,135
2011-05-18 16:00:00,2,3,17.6,98.85,7.64,32,173,205
2011-05-18 17:00:00,1,1,6.83,49.45,18.14,24,172,196
2011-05-18 18:00:00,2,2,19.68,48.12,35.69,13,159,172
2011-05-18 19:00:00,1,1,29.4,71.0,1.59,28,4,32
2011-05-18 20:00:00,1,2,7.96,96.92,42.61,12,75,87
2011-05-18 21:00:00,2,3,7.09,98.1,47.08,14,103,117
2011-05-18 22:00:00,3,2,9.61,76.58,44.44,7,133,140
2011-05-18 23:00:00,1,3,27.93,80.37,45.65,46,81,127
2011-05-19 00:00:00,1,1,26.72,65.07,0.77,44,6,50
2011-05-19 01:00:00,1,2,21.95,80.46,48.89,32,14,46
2011-05-19 02:00:00,3,4,19.05,88.78,18.32,10,72,82
2011-05-19 03:00:00,3,4,31.65,58.89,43.46,14,19,33
2011-05-19 04:00:00,4,1,28.0,69.59,9.34,20,58,78
2011-05-19 05:00:00,2,2,29.36,62.99,22.33,35,3,38
2011-05-19 06:00:00,3,4,29.4,65.0,2.21,5,105,110
2011-05-19 07:00:00,2,3,24.28,91.2,2.0,24,39,63
2011-05-19 08:00:00,4,2,18.74,48.45,47.16,43,64,107
2011-05-19 09:00:00,2,2,30.94,36.65,40.53,0,34,34
2011-05-19 10:00:00,3,4,32.78,56.5,26.49,41,43,84
2011-05-19 11:00:00,2,3,5.71,36.65,26.27,49,6,55
2011-05-19 12:00:00,3,3,6.55,59.87,37.44,32,149,181
2011-05-19 13:00:00,2,3,33.76,92.28,17.08,38,22,60
2011-05-19 14:00:00,3,2,13.31,69.39,38.09,31,64,95
2011-05-19 15:00:00,3,1,31.2,88.43,24.25,1,87,88
2011-05-19 16:00:00,2,2,16.66,33.3,31.9,24,19,43
2011-05-19 17:00:00,4,2,8.57,92.07,48.24,39,31,70
2011-05-19 18:00:00,1,4,7.41,68.14,23.57,32,96,128
2011-05-19 19:00:00,4,1,9.7,22.54,20.92,37,163,200
2011-05-19 20:00:00,2,3,12.5,70.65,45.29,10,145,155
2011-05-19 21:00:00,4,4,19.66,96.11,45.13,18,96,114
2011-05-19 22:00:00,3,2,26.04,26.33,49.62,24,160,184
2011-05-19 23:00:00,1,1,34.59,66.6,27.54,27,68,95
2011-05-20 00:00:00,2,3,18.25,93.24,17.21,9,81,90
2011-05-20 01:00:00,2,3,20.55,20.78,12.02,30,8,38
2011-05-20 02:00:00,2,2,20.65,70.47,1.7,15,41,56
2011-05-20 03:00:00,1,3,21.18,57.99,36.34,47,198,245
2011-05-20 04:00:00,3,3,20.53,47.76,11.67,41,126,167
2011-05-20 05:00:00,2,1,5.26,70.2,30.33,17,109,126
2011-05-20 06:00:00,4,4,5.05,24.22,45.83,21,131,152
2011-05-20 07:00:00,2,1,7.93,80.25,47.51,49,173,222
2011-05-20 08:00:00,2,4,8.05,20.36,0.22,34,71,105
2011-05-20 09:00:00,2,4,26.15,44.55,15.85,11,151,162
2011-05-20 10:00:00,2,4,11.15,60.32,41.87,41,71,112
2011-05-20 11:00:00,3,3,31.84,50.16,26.82,27,123,150
2011-05-20 12:00:00,4,1,32.86,44.6,40.38,47,196,243
2011-05-20 13:00:00,3,3,34.28,86.47,42.67,8,22,30
2011-05-20 14:00:00,4,2,33.17,94.79,22.13,29,106,135
2011-05-20 15:00:00,2,1,13.16,89.9,17.95,17,182,199
2011-05-20 16:00:00,1,4,20.29,61.79,22.77,44,97,141
2011-05-20 17:00:00,3,3,10.26,90.73,32.64,23,142,165
2011-05-20 18:00:00,1,3,29.19,93.67,18.36,45,50,95
2011-05-20 19:00:00,3,1,31.65,52.74,38.75,18,122,140
2011-05-20 20:00:00,2,1,30.54,42.68,45.2,13,49,62
2011-05-20 21:00:00,3,4,18.0,27.86,14.12,1,174,175
2011-05-20 22:00:00,2,4,27.76,58.33,48.25,10,82,92
2011-05-20 23:00:00,3,2,7.93,95.7,31.14,25,24,49
2011-05-21 00:00:00,2,4,6.21,64.87,43.91,7,38,45
2011-05-21 01:00:00,2,3,27.6,73.4,5.2,2,67,69
2011-05-21 02:00:00,4,2,17.76,29.03,12.57,14,173,187
2011-05-21 03:00:00,2,2,34.87,31.48,16.05,44,71,115
2011-05-21 04:00:00,4,2,7.92,57.16,15.14,39,118,157
2011-05-21 05:00:00,2,1,30.67,96.1,8.59,12,105,117
2011-05-21 06:00:00,1,4,19.4,48.86,43.41,15,12,27
2011-05-21 07:00:00,2,2,29.81,90.2,20.93,21,165,186
2011-05-21 08:00:00,1,1,29.51,29.62,48.16,32,35,67
2011-05-21 09:00:00,1,1,32.48,69.36,29.17,1,164,165
2011-05-21 10:00:00,2,2,13.94,68.05,6.92,44,169,213
2011-05-21 11:00:00,1,2,33.49,88.79,27.3,28,119,147
2011-05-21 12:00:00,4,3,9.55,20.27,49.68,45,108,153
2011-05-21 13:00:00,3,2,7.46,35.19,28.26,33,123,156
2011-05-21 14:00:00,2,3,17.95,37.58,0.09,15,18,33
2011-05-21 15:00:00,1,2,29.85,96.0,46.65,13,36,49
2011-05-21 16:00:00,2,2,19.2,32.3,11.74,38,100,138
2011-05-21 17:00:00,4,4,29.88,22.96,34.43,45,192,237
2011-05-21 18:00:00,2,2,26.89,62.76,25.75,49,84,133
2011-05-21 19:00:00,2,2,11.28,62.28,16.27,48,38,86
2011-05-21 20:00:00,1,3,33.47,87.52,14.13,4,153,157
2011-05-21 21:00:00,4,3,6.82,95.91,46.44,42,41,83
2011-05-21 22:00:00,3,4,31.95,63.08,45.6,17,189,206
2011-05-21 23:00:00,3,2,14.13,94.4,25.66,47,52,99
2011-05-22 00:00:00,1,2,20.0,78.01,12.92,25,194,219
2011-05-22 01:00:00,2,3,17.67,41.16,5.12,9,49,58
2011-05-22 02:00:00,1,1,10.16,94.27,7.83,5,104,109
2011-05-22 03:00:00,1,1,15.74,73.4,26.11,13,196,209
2011-05-22 04:00:00,1,1,10.79,53.13,15.39,1,106,107
2011-05-22 05:00:00,2,3,11.12,74.42,2.1,26,156,182
2011-05-22 06:00:00,4,3,10.61,52.11,22.76,8,129,137
2011-05-22 07:00:00,1,1,19.67,29.13,37.31,12,17,29
2011-05-22 08:00:00,2,1,28.94,77.52,44.58,20,59,79
2011-05-22 09:00:00,4,2,22.07,85.93,29.26,43,115,158
2011-05-22 10:00:00,1,3,31.8,78.3,36.16,1,141,142
2011-05-22 11:00:00,3,3,24.1,38.33,18.2,2,117,119
2011-05-22 12:00:00,4,1,25.68,96.53,24.81,12,167,179
2011-05-22 13:00:00,1,1,25.03,22.02,36.48,20,191,211
2011-05-22 14:00:00,4,4,18.48,46.61,36.38,32,29,61
2011-05-22 15:00:00,4,3,25.68,40.81,21.23,19,28,47
2011-05-22 16:00:00,4,4,7.09,23.85,27.18,35,156,191
2011-05-22 17:00:00,4,2,30.8,52.46,46.19,17,18,35
2011-05-22 18:00:00,4,4,28.33,69.85,31.6,24,89,113
2011-05-22 19:00:00,4,1,12.36,90.6,32.13,44,109,153
2011-05-22 20:00:00,1,3,28.04,99.18,39.23,37,57,94
2011-05-22 21:00:00,3,3,5.38,84.65,5.76,24,115,139
2011-05-22 22:00:00,2,4,11.52,57.49,26.14,37,39,76
2011-05-22 23:00:00,4,4,6.95,77.9,47.97,14,8,22
2011-05-23 00:00:00,2,2,28.41,87.49,18.08,49,120,169
2011-05-23 01:00:00,1,2,27.68,57.22,14.75,16,109,125
2011-05-23 02:00:00,4,1,29.41,82.8,30.06,45,107,152
2011-05-23 03:00:00,3,1,5.13,58.61,11.06,35,158,193
2011-05-23 04:00:00,2,1,20.04,50.92,27.8,28,77,105
2011-05-23 05:00:00,4,4,26.15,62.09,7.78,32,94,126
2011-05-23 06:00:00,1,4,9.66,74.07,28.99,31,142,173
2011-05-23 07:00:00,3,3,24.49,78.15,30.12,7,33,40
2011-05-23 08:00:00,2,1,7.52,48.54,20.92,42,61,103
2011-05-23 09:00:00,2,4,10.44,65.71,19.14,12,73,85
2011-05-23 10:00:00,4,3,19.27,92.79,12.27,16,56,72
2011-05-23 11:00:00,3,1,24.61,98.11,16.55,20,148,168
2011-05-23 12:00:00,3,2,9.38,38.18,24.92,13,102,115
2011-05-23 13:00:00,3,2,10.56,35.43,12.38,24,53,77
2011-05-23 14:00:00,3,4,11.13,74.13,39.14,48,164,212
2011-05-23 15:00:00,1,3,12.16,53.17,35.45,23,167,190
2011-05-23 16:00:00,3,2,11.8,21.94,13.47,32,19,51
2011-05-23 17:00:00,2,3,16.85,47.75,4.87,7,108,115
2011-05-23 18:00:00,2,3,24.61,84.54,0.01,27,198,225
2011-05-23 19:00:00,1,2,18.14,83.79,29.84,18,145,163
2011-05-23 20:00:00,2,3,28.28,59.57,10.57,10,171,181
2011-05-23 21:00:00,2,2,26.58,57.81,0.63,9,183,192
2011-05-23 22:00:00,3,4,8.8,66.36,17.95,0,16,16
2011-05-23 23:00:00,2,1,6.47,37.55,48.1,4,41,45
2011-05-24 00:00:00,1,1,31.34,62.08,34.5,15,198,213
2011-05-24 01:00:00,3,4,7.39,20.88,42.89,19,155,174
2011-05-24 02:00:00,4,2,9.45,58.04,7.24,19,20,39
2011-05-24 03:00:00,3,2,5.66,46.88,3.66,27,164,191
2011-05-24 04:00:00,1,2,23.85,73.99,0.58,4,150,154
2011-05-24 05:00:00,3,2,22.47,71.07,47.78,47,110,157
2011-05-24 06:00:00,3,4,34.61,50.47,15.01,2,47,49
2011-05-24 07:00:00,1,1,31.61,20.58,22.98,29,58,87
2011-05-24 08:00:00,3,3,17.33,40.18,19.73,22,127,149
2011-05-24 09:00:00,1,3,16.15,70.67,36.52,33,111,144
2011-05-24 10:00:00,1,1,13.91,25.79,15.5,48,51,99
2011-05-24 11:00:00,4,4,9.57,28.61,26.77,27,16,43
2011-05-24 12:00:00,2,3,9.14,71.76,49.78,0,37,37
2011-05-24 13:00:00,2,1,8.97,80.46,22.2,47,128,175
2011-05-24 14:00:00,3,4,8.42,45.72,27.56,26,74,100
2011-05-24 15:00:00,3,3,12.22,59.17,25.13,33,160,193
2011-05-24 16:00:00,4,2,14.2,95.66,40.16,30,94,124
2011-05-24 17:00:00,4,2,33.85,95.64,13.34,31,43,74
2011-05-24 18:00:00,4,4,22.35,44.6,8.52,6,87,93
2011-05-24 19:00:00,1,2,34.63,84.8,37.7,42,19,61
2011-05-24 20:00:00,4,4,16.17,67.52,20.78,37,174,211
2011-05-24 21:00:00,4,1,18.73,98.04,45.69,33,68,101
2011-05-24 22:00:00,3,1,14.74,58.21,32.21,45,169,214
2011-05-24 23:00:00,4,3,10.49,81.98,28.22,3,153,156
2011-05-25 00:00:00,1,4,9.29,81.45,3.52,18,48,66
2011-05-25 01:00:00,1,3,33.35,59.79,36.52,21,105,126
2011-05-25 02:00:00,3,3,34.6,83.65,34.3,28,70,98
2011-05-25 03:00:00,4,1,6.35,40.88,32.0,33,17,50
2011-05-25 04:00:00,4,3,9.51,29.78,13.4,33,101,134
2011-05-25 05:00:00,1,2,17.71,54.01,47.34,44,94,138
2011-05-25 06:00:00,4,3,10.59,95.49,16.08,44,8,52
2011-05-25 07:00:00,4,4,15.92,60.06,7.61,2,65,67
2011-05-25 08:00:00,4,2,8.87,70.82,49.36,20,59,79
2011-05-25 09:00:00,2,1,18.7,69.93,37.31,37,107,144
2011-05-25 10:00:00,3,4,13.15,30.61,20.74,20,36,56
2011-05-25 11:00:00,2,2,15.56,51.22,46.8,16,174,190
2011-05-25 12:00:00,3,4,7.83,76.56,4.56,28,28,56
2011-05-25 13:00:00,1,2,17.84,97.76,4.38,32,62,94
2011-05-25 14:00:00,4,4,34.5,33.44,34.12,38,14,52
2011-05-25 15:00:00,3,4,14.86,52.84,8.9,25,8,33
2011-05-25 16:00:00,2,2,31.29,27.61,45.86,6,79,85
2011-05-25 17:00:00,4,1,30.3,39.39,42.02,44,65,109
2011-05-25 18:00:00,1,1,33.56,50.14,15.32,8,0,8
2011-05-25 19:00:00,3,4,28.7,63.25,44.44,17,120,137
2011-05-25 20:00:00,3,4,24.79,38.45,2.14,0,8,8
2011-05-25 21:00:00,3,1,30.7,38.21,27.43,10,56,66
2011-05-25 22:00:00,4,1,7.27,82.23,46.78,21,183,204
2011-05-25 23:00:00,2,3,18.88,97.01,42.77,31,147,178
2011-05-26 00:00:00,2,1,34.68,45.89,17.8,42,120,162
2011-05-26 01:00:00,3,4,28.09,75.04,9.14,9,1,10
2011-05-26 02:00:00,1,2,33.86,40.65,10.53,48,0,48
2011-05-26 03:00:00,1,1,28.39,94.24,25.73,26,73,99
2011-05-26 04:00:00,2,3,31.25,73.83,29.84,48,53,101
2011-05-26 05:00:00,1,3,26.2,84.21,1.64,11,18,29
2011-05-26 06:00:00,2,3,27.82,23.95,20.68,29,17,46
2011-05-26 07:00:00,3,2,20.7,67.88,41.52,9,23,32
2011-05-26 08:00:00,2,1,32.73,62.21,22.22,11,126,137
2011-05-26 09:00:00,2,1,29.75,43.44,8.46,37,51,88
2011-05-26 10:00:00,3,1,30.32,40.99,47.74,20,19,39
2011-05-26 11:00:00,1,2,25.19,66.4,13.31,26,138,164
2011-05-26 12:00:00,2,2,14.14,76.52,39.92,5,72,77
2011-05-26 13:00:00,2,4,6.07,22.65,9.69,37,187,224
2011-05-26 14:00:00,3,3,33.07,65.39,21.16,7,15,22
2011-05-26 15:00:00,1,3,22.58,33.64,24.52,36,140,176
2011-05-26 16:00:00,2,1,13.94,31.23,25.03,5,180,185
2011-05-26 17:00:00,3,2,9.47,69.85,25.82,33,5,38
2011-05-26 18:00:00,2,2,29.89,44.87,11.25,48,24,72
2011-05-26 19:00:00,4,1,30.1,55.27,25.8,39,62,101
2011-05-26 20:00:00,3,1,29.44,48.8,24.09,21,174,195
2011-05-26 21:00:00,1,4,24.35,71.87,10.44,28,14,42
2011-05-26 22:00:00,1,3,15.98,57.61,49.41,8,53,61
2011-05-26 23:00:00,1,3,14.12,97.08,43.28,20,170,190
2011-05-27 00:00:00,1,3,5.26,48.19,44.38,31,127,158
2011-05-27 01:00:00,2,4,30.01,79.22,34.28,7,13,20
2011-05-27 02:00:00,2,1,7.62,40.58,7.99,42,33,75
2011-05-27 03:00:00,1,1,23.92,60.7,28.4,9,129,138
2011-05-27 04:00:00,1,3,20.12,64.21,41.07,48,19,67
2011-05-27 05:00:00,1,3,20.8,46.33,1.94,22,105,127
2011-05-27 06:00:00,2,4,32.8,57.74,24.79,19,15,34
2011-05-27 07:00:00,1,2,5.95,42.34,19.81,12,194,206
2011-05-27 08:00:00,1,2,28.2,20.48,10.61,21,157,178
2011-05-27 09:00:00,4,3,6.56,37.25,18.91,40,102,142
2011-05-27 10:00:00,4,4,6.14,76.01,49.17,14,50,64
2011-05-27 11:00:00,1,3,17.89,81.68,36.16,30,130,160
2011-05-27 12:00:00,3,2,6.89,42.42,14.98,44,76,120
2011-05-27 13:00:00,1,3,28.67,52.64,30.27,31,127,158
2011-05-27 14:00:00,4,2,20.89,22.99,12.33,44,178,222
2011-05-27 15:00:00,3,2,5.87,38.97,30.54,12,120,132
2011-05-27 16:00:00,3,2,6.22,82.34,44.81,24,45,69
2011-05-27 17:00:00,1,1,23.38,68.48,27.84,20,39,59
2011-05-27 18:00:00,4,1,29.18,36.46,36.67,3,28,31
2011-05-27 19:00:00,4,3,18.13,40.6,22.67,41,150,191
2011-05-27 20:00:00,3,2,21.64,85.34,26.21,14,144,158
2011-05-27 21:00:00,1,1,28.99,36.73,34.75,20,92,112
2011-05-27 22:00:00,2,3,23.32,46.73,40.62,41,68,109
2011-05-27 23:00:00,2,3,11.74,73.15,32.97,7,84,91
2011-05-28 00:00:00,4,3,23.39,64.89,48.87,30,65,95
2011-05-28 01:00:00,2,3,23.85,56.87,40.99,9,150,159
2011-05-28 02:00:00,4,3,27.02,91.98,38.86,20,74,94
2011-05-28 03:00:00,4,4,23.63,37.58,42.26,16,150,166
2011-05-28 04:00:00,4,2,34.08,79.31,14.06,4,134,138
2011-05-28 05:00:00,2,3,10.92,32.73,21.6,12,170,182
2011-05-28 06:00:00,4,4,33.53,69.26,28.22,20,189,209
2011-05-28 07:00:00,3,2,21.15,89.65,23.12,43,33,76
2011-05-28 08:00:00,1,1,25.16,56.63,42.37,11,101,112
2011-05-28 09:00:00,1,3,7.98,77.94,1.35,24,104,128
2011-05-28 10:00:00,4,4,16.42,85.63,10.46,27,112,139
2011-05-28 11:00:00,1,1,28.08,30.88,44.09,1,50,51
2011-05-28 12:00:00,2,4,26.21,76.47,2.96,20,171,191
2011-05-28 13:00:00,2,2,6.2,93.59,11.35,40,69,109
2011-05-28 14:00:00,1,2,21.4,66.11,17.56,21,182,203
2011-05-28 15:00:00,2,1,7.65,34.89,37.54,1,65,66
2011-05-28 16:00:00,1,4,34.88,30.16,28.01,29,95,124
2011-05-28 17:00:00,1,3,31.92,40.78,47.73,0,57,57
2011-05-28 18:00:00,1,3,5.63,28.28,11.39,45,119,164
2011-05-28 19:00:00,4,1,30.76,61.07,43.61,12,170,182
2011-05-28 20:00:00,1,1,32.58,25.58,14.15,2,110,112
2011-05-28 21:00:00,4,1,15.61,37.87,12.27,19,60,79
2011-05-28 22:00:00,1,4,26.59,55.19,24.92,4,165,169
2011-05-28 23:00:00,1,3,18.26,57.91,3.56,1,155,156
2011-05-29 00:00:00,1,3,24.66,65.23,19.22,25,184,209
2011-05-29 01:00:00,2,3,15.21,76.45,17.78,28,40,68
2011-05-29 02:00:00,4,1,14.68,23.78,8.01,17,49,66
2011-05-29 03:00:00,4,3,17.73,26.45,43.04,8,89,97
2011-05-29 04:00:00,1,2,9.37,24.87,19.29,21,89,110
2011-05-29 05:00:00,1,1,29.93,53.85,49.1,27,188,215
2011-05-29 06:00:00,2,3,15.46,23.35,44.99,11,68,79
2011-05-29 07:00:00,2,4,17.0,79.69,9.74,36,190,226
2011-05-29 08:00:00,2,1,31.82,37.84,25.26,17,120,137
2011-05-29 09:00:00,4,2,19.9,95.14,30.09,33,80,113
2011-05-29 10:00:00,4,2,21.33,58.91,40.95,41,25,66
2011-05-29 11:00:00,4,4,33.69,55.71,44.28,41,153,194
2011-05-29 12:00:00,1,4,31.6,82.44,31.2,2,106,108
2011-05-29 13:00:00,4,1,10.08,77.05,1.76,45,150,195
2011-05-29 14:00:00,3,1,19.2,68.58,24.06,4,179,183
2011-05-29 15:00:00,3,2,34.14,94.81,44.24,22,87,109
2011-05-29 16:00:00,2,4,16.17,53.78,35.7,12,104,116
2011-05-29 17:00:00,4,1,16.15,84.68,43.51,23,72,95
2011-05-29 18:00:00,3,2,10.85,50.41,33.7,27,115,142
2011-05-29 19:00:00,2,4,8.43,87.07,2.2,16,197,213
2011-05-29 20:00:00,4,2,27.21,40.76,48.4,5,131,136
2011-05-29 21:00:00,1,3,28.1,43.14,45.9,26,0,26
2011-05-29 22:00:00,3,4,34.07,74.23,6.33,44,133,177
2011-05-29 23:00:00,1,1,28.2,37.02,5.63,28,183,211
2011-05-30 00:00:00,4,1,12.3,38.33,26.95,11,28,39
2011-05-30 01:00:00,3,3,6.2,44.42,37.85,34,130,164
2011-05-30 02:00:00,4,4,34.56,74.31,19.11,47,127,174
2011-05-30 03:00:00,1,2,15.21,91.15,6.82,4,108,112
2011-05-30 04:00:00,3,1,14.36,73.97,25.53,1,87,88
2011-05-30 05:00:00,1,3,32.18,86.23,16.88,10,169,179
2011-05-30 06:00:00,4,3,22.55,63.48,17.59,3,136,139
2011-05-30 07:00:00,4,4,11.45,25.51,32.25,21,80,101
2011-05-30 08:00:00,1,4,31.67,28.04,44.28,0,58,58
2011-05-30 09:00:00,3,1,34.8,64.35,27.93,44,37,81
2011-05-30 10:00:00,1,3,7.6,46.22,34.38,49,41,90
2011-05-30 11:00:00,4,2,30.87,37.65,33.0,15,49,64
2011-05-30 12:00:00,1,3,16.72,57.3,27.56,1,13,14
2011-05-30 13:00:00,4,2,20.72,73.32,15.54,40,125,165
2011-05-30 14:00:00,1,2,32.44,50.8,18.89,26,99,125
2011-05-30 15:00:00,3,1,34.2,84.2,15.79,11,172,183
2011-05-30 16:00:00,3,3,12.86,79.08,45.87,4,32,36
2011-05-30 17:00:00,1,2,11.39,78.79,41.33,4,147,151
2011-05-30 18:00:00,1,4,7.42,98.82,28.97,21,161,182
2011-05-30 19:00:00,3,2,21.85,43.62,45.61,12,66,78
2011-05-30 20:00:00,4,4,5.41,71.58,44.32,15,83,98
2011-05-30 21:00:00,3,4,17.36,88.44,46.38,25,66,91
2011-05-30 22:00:00,4,3,7.2,66.36,11.09,8,69,77
2011-05-30 23:00:00,1,4,17.16,83.16,35.88,47,166,213
2011-05-31 00:00:00,1,2,6.2,53.16,30.46,31,170,201
2011-05-31 01:00:00,4,4,30.06,67.24,36.69,18,166,184
2011-05-31 02:00:00,1,3,11.29,24.45,13.17,35,112,147
2011-05-31 03:00:00,4,1,14.85,98.86,34.74,27,84,111
2011-05-31 04:00:00,2,2,31.1,84.0,20.49,14,114,128
2011-05-31 05:00:00,3,2,27.39,89.5,41.7,8,43,51
2011-05-31 06:00:00,2,3,11.57,75.54,39.77,15,128,143
2011-05-31 07:00:00,4,3,7.16,34.88,10.57,5,96,101
2011-05-31 08:00:00,3,3,26.47,22.48,9.19,7,49,56
2011-05-31 09:00:00,4,3,16.72,89.17,35.89,32,119,151
2011-05-31 10:00:00,3,2,27.98,51.71,27.52,31,115,146
2011-05-31 11:00:00,3,1,18.36,41.11,27.86,45,61,106
2011-05-31 12:00:00,3,4,15.38,64.93,37.63,35,2,37
2011-05-31 13:00:00,3,4,18.54,53.67,42.75,41,135,176
2011-05-31 14:00:00,4,1,27.46,72.13,11.95,47,47,94
2011-05-31 15:00:00,3,1,32.07,58.7,27.78,35,113,148
2011-05-31 16:00:00,3,1,6.49,75.78,41.45,33,95,128
2011-05-31 17:00:00,2,3,20.72,88.27,43.64,1,168,169
2011-05-31 18:00:00,1,2,5.99,35.64,14.37,12,163,175
2011-05-31 19:00:00,1,2,19.05,46.35,5.21,42,56,98
2011-05-31 20:00:00,2,2,31.56,54.95,11.64,9,84,93
2011-05-31 21:00:00,2,3,15.85,96.96,47.27,37,89,126
2011-05-31 22:00:00,4,2,32.97,49.23,23.12,6,118,124
2011-05-31 23:00:00,4,3,23.92,50.49,20.93,46,77,123
2011-06-01 00:00:00,4,2,33.02,72.28,0.65,2,170,172
2011-06-01 01:00:00,2,1,27.71,53.54,2.55,26,27,53
2011-06-01 02:00:00,2,4,8.1,96.1,33.43,13,91,104
2011-06-01 03:00:00,3,4,11.93,91.56,29.49,29,84,113
2011-06-01 04:00:00,4,3,16.83,61.07,28.78,33,111,144
2011-06-01 05:00:00,4,2,10.1,71.58,5.52,22,186,208
2011-06-01 06:00:00,4,4,19.85,24.64,17.6,47,117,164
2011-06-01 07:00:00,1,1,19.14,75.66,40.62,16,156,172
2011-06-01 08:00:00,3,1,33.69,76.58,8.75,14,37,51
2011-06-01 09:00:00,4,1,18.01,48.74,44.13,44,161,205
2011-06-01 10:00:00,4,3,28.57,37.57,6.07,43,64,107
2011-06-01 11:00:00,4,3,33.26,93.21,8.46,6,147,153
2011-06-01 12:00:00,1,2,31.31,54.14,23.89,2,25,27
2011-06-01 13:00:00,1,1,11.26,72.3,47.26,8,26,34
2011-06-01 14:00:00,2,2,19.88,22.67,16.48,2,150,152
2011-06-01 15:00:00,3,2,15.43,53.13,32.91,47,198,245
2011-06-01 16:00:00,2,1,17.0,85.38,29.43,34,21,55
2011-06-01 17:00:00,3,2,15.82,51.01,7.48,39,174,213
2011-06-01 18:00:00,1,4,29.79,68.25,12.41,7,195,202
2011-06-01 19:00:00,4,3,18.56,36.79,46.51,25,100,125
2011-06-01 20:00:00,2,2,20.71,53.32,9.24,14,66,80
2011-06-01 21:00:00,4,1,34.47,94.21,34.75,4,193,197
2011-06-01 22:00:00,2,3,6.8,65.32,48.23,12,68,80
2011-06-01 23:00:00,1,3,19.64,92.15,5.98,14,81,95
2011-06-02 00:00:00,1,2,28.22,92.16,19.96,38,97,135
2011-06-02 01:00:00,1,4,9.53,95.53,11.2,11,14,25
2011-06-02 02:00:00,2,2,23.35,91.63,11.08,34,125,159
2011-06-02 03:00:00,3,4,12.18,20.26,5.95,7,113,120
2011-06-02 04:00:00,2,3,31.02,94.72,32.48,9,103,112
2011-06-02 05:00:00,3,2,14.81,31.0,37.32,33,171,204
2011-06-02 06:00:00,2,1,14.87,23.19,33.84,7,50,57
2011-06-02 07:00:00,2,2,22.95,24.43,46.23,21,192,213
2011-06-02 08:00:00,1,4,10.51,47.91,7.28,49,152,201
2011-06-02 09:00:00,4,4,13.55,69.66,15.99,11,188,199
2011-06-02 10:00:00,4,2,17.5,52.18,17.23,21,144,165
2011-06-02 11:00:00,3,4,15.61,22.04,11.6,26,96,122
2011-06-02 12:00:00,4,3,20.75,58.12,7.11,17,51,68
2011-06-02 13:00:00,2,2,22.99,55.37,24.34,18,57,75
2011-06-02 14:00:00,2,4,22.0,80.55,41.72,4,184,188
2011-06-02 15:00:00,1,2,24.63,42.37,47.73,15,165,180
2011-06-02 16:00:00,1,2,14.23,37.4,6.47,48,68,116
2011-06-02 17:00:00,4,1,8.79,40.48,41.16,40,122,162
2011-06-02 18:00:00,3,2,27.82,44.3,41.23,9,36,45
2011-06-02 19:00:00,4,1,30.52,67.93,19.45,18,74,92
2011-06-02 20:00:00,4,4,12.71,57.72,5.5,43,107,150
2011-06-02 21:00:00,4,1,17.21,46.95,49.5,0,161,161
2011-06-02 22:00:00,4,1,19.96,49.95,32.78,21,34,55
2011-06-02 23:00:00,2,1,21.0,49.67,49.11,16,187,203
2011-06-03 00:00:00,3,3,24.78,97.79,24.18,34,38,72
2011-06-03 01:00:00,2,1,6.25,38.64,19.76,38,173,211
2011-06-03 02:00:00,3,2,26.64,85.44,12.36,8,117,125
2011-06-03 03:00:00,1,1,6.86,76.66,49.18,4,143,147
2011-06-03 04:00:00,4,2,19.05,20.45,12.66,8,87,95
2011-06-03 05:00:00,2,1,29.83,99.45,1.19,10,158,168
2011-06-03 06:00:00,3,3,18.54,80.52,25.62,13,13,26
2011-06-03 07:00:00,1,4,9.47,74.6,18.85,45,46,91
2011-06-03 08:00:00,1,1,34.55,52.43,13.07,39,159,198
2011-06-03 09:00:00,4,1,31.68,64.42,31.73,23,106,129
2011-06-03 10:00:00,3,3,28.14,40.26,18.21,19,76,95
2011-06-03 11:00:00,2,1,17.35,22.84,20.11,32,101,133
2011-06-03 12:00:00,4,2,10.52,86.88,1.15,3,16,19
2011-06-03 13:00:00,2,1,33.24,91.72,29.45,15,123,138
2011-06-03 14:00:00,1,1,20.97,33.0,6.1,24,123,147
2011-06-03 15:00:00,2,4,30.57,82.96,10.69,0,183,183
2011-06-03 16:00:00,2,4,15.26,79.29,35.86,23,163,186
2011-06-03 17:00:00,4,1,15.06,34.27,15.66,2,116,118
2011-06-03 18:00:00,2,3,34.57,53.75,8.16,31,169,200
2011-06-03 19:00:00,4,4,20.65,53.82,28.87,33,81,114
2011-06-03 20:00:00,1,1,9.22,80.8,10.75,48,146,194
2011-06-03 21:00:00,4,4,11.59,87.01,13.55,24,134,158
2011-06-03 22:00:00,4,1,19.46,27.58,31.07,42,54,96
2011-06-03 23:00:00,3,4,6.27,65.04,36.99,2,157,159
2011-06-04 00:00:00,2,4,18.88,80.94,36.98,6,75,81
2011-06-04 01:00:00,1,2,17.57,82.9,24.11,41,119,160
2011-06-04 02:00:00,4,1,28.38,31.84,22.71,34,28,62
2011-06-04 03:00:00,1,1,15.65,62.04,39.38,28,194,222
2011-06-04 04:00:00,3,1,34.48,88.6,9.65,39,161,200
2011-06-04 05:00:00,2,1,10.42,45.48,7.61,24,161,185
2011-06-04 06:00:00,4,4,22.73,54.01,33.23,27,85,112
2011-06-04 07:00:00,2,2,7.69,84.35,20.48,23,1,24
2011-06-04 08:00:00,3,2,27.02,27.15,35.5,4,154,158
2011-06-04 09:00:00,3,3,34.84,88.76,12.83,26,46,72
2011-06-04 10:00:00,1,1,29.57,44.89,16.24,9,99,108
2011-06-04 11:00:00,4,3,21.67,20.12,44.83,11,56,67
2011-06-04 12:00:00,1,4,19.54,38.73,21.08,17,121,138
2011-06-04 13:00:00,3,3,30.05,27.16,29.55,37,144,181
2011-06-04 14:00:00,2,1,33.08,27.39,5.33,7,97,104
2011-06-04 15:00:00,1,2,34.68,75.43,8.94,49,153,202
2011-06-04 16:00:00,1,2,16.9,37.12,1.79,37,124,161
2011-06-04 17:00:00,2,1,34.73,94.78,21.22,29,137,166
2011-06-04 18:00:00,1,4,9.68,61.32,49.45,8,38,46
2011-06-04 19:00:00,2,1,12.61,56.81,43.69,47,8,55
2011-06-04 20:00:00,4,4,7.67,54.74,31.65,42,24,66
2011-06-04 21:00:00,2,2,13.15,75.41,43.05,24,147,171
2011-06-04 22:00:00,4,4,28.04,56.18,29.71,29,14,43
2011-06-04 23:00:00,2,1,30.59,30.29,18.44,1,112,113
2011-06-05 00:00:00,3,1,28.37,90.41,8.68,16,90,106
2011-06-05 01:00:00,3,1,23.93,54.27,32.65,44,138,182
2011-06-05 02:00:00,4,4,20.42,25.92,9.65,6,143,149
2011-06-05 03:00:00,4,4,26.26,62.35,20.87,21,149,170
2011-06-05 04:00:00,3,4,16.73,71.79,41.29,9,189,198
2011-06-05 05:00:00,4,2,30.24,42.05,6.46,25,151,176
2011-06-05 06:00:00,2,3,25.32,84.03,6.45,12,163,175
2011-06-05 07:00:00,2,3,25.93,73.58,11.22,41,145,186
2011-06-05 08:00:00,3,1,21.08,72.03,27.6,27,147,174
2011-06-05 09:00:00,1,2,31.56,53.67,12.59,35,7,42
2011-06-05 10:00:00,2,4,12.56,96.95,25.16,10,14,24
2011-06-05 11:00:00,4,1,16.43,41.94,15.1,8,76,84
2011-06-05 12:00:00,1,2,28.33,66.22,25.31,15,124,139
2011-06-05 13:00:00,1,1,19.78,44.72,13.88,16,77,93
2011-06-05 14:00:00,2,2,31.68,79.58,49.0,4,46,50
2011-06-05 15:00:00,2,2,15.39,23.82,24.64,4,118,122
2011-06-05 16:00:00,1,3,16.08,23.67,37.18,37,151,188
2011-06-05 17:00:00,1,1,31.66,84.87,35.03,30,46,76
2011-06-05 18:00:00,3,4,18.93,54.74,24.53,1,17,18
2011-06-05 19:00:00,4,3,20.48,47.29,11.94,26,159,185
2011-06-05 20:00:00,3,3,14.98,68.6,25.54,45,169,214
2011-06-05 21:00:00,2,4,13.3,76.15,34.05,42,95,137
2011-06-05 22:00:00,3,2,24.68,36.1,23.0,18,164,182
2011-06-05 23:00:00,3,4,8.6,34.83,4.1,42,32,74
2011-06-06 00:00:00,3,1,31.38,96.65,0.9,24,128,152
2011-06-06 01:00:00,3,4,28.38,67.17,16.39,37,91,128
2011-06-06 02:00:00,4,2,10.72,51.21,7.51,12,154,166
2011-06-06 03:00:00,4,4,25.82,84.12,45.31,28,16,44
2011-06-06 04:00:00,1,2,23.08,62.01,8.79,18,45,63
2011-06-06 05:00:00,2,2,10.54,39.33,19.71,34,78,112
2011-06-06 06:00:00,3,1,13.2,36.54,35.6,24,94,118
2011-06-06 07:00:00,1,4,17.27,51.75,40.77,47,161,208
2011-06-06 08:00:00,1,4,25.98,88.79,23.89,8,2,10
2011-06-06 09:00:00,1,1,24.16,24.92,9.06,34,55,89
2011-06-06 10:00:00,4,2,20.97,37.48,13.54,14,139,153
2011-06-06 11:00:00,3,4,28.05,91.45,20.95,21,25,46
2011-06-06 12:00:00,3,1,27.74,29.74,18.23,12,151,163
2011-06-06 13:00:00,2,2,23.54,70.37,17.43,48,59,107
2011-06-06 14:00:00,3,1,28.61,37.08,6.59,29,57,86
2011-06-06 15:00:00,3,4,15.03,68.47,45.67,20,190,210
2011-06-06 16:00:00,1,1,31.44,50.65,1.49,24,7,31
2011-06-06 17:00:00,2,3,23.45,28.13,22.0,24,25,49
2011-06-06 18:00:00,3,2,29.67,66.6,49.02,39,109,148
2011-06-06 19:00:00,4,3,21.39,74.64,32.99,21,185,206
2011-06-06 20:00:00,3,3,11.55,74.42,17.77,45,165,210
2011-06-06 21:00:00,1,2,21.27,70.96,7.3,40,48,88
2011-06-06 22:00:00,4,2,16.13,60.02,48.19,2,42,44
2011-06-06 23:00:00,1,1,25.92,61.56,0.7,8,186,194
2011-06-07 00:00:00,3,2,19.27,70.85,34.07,23,20,43
2011-06-07 01:00:00,4,3,30.08,75.22,44.01,43,140,183
2011-06-07 02:00:00,2,3,25.34,72.39,1.26,46,98,144
2011-06-07 03:00:00,2,4,25.54,66.96,36.26,31,130,161
2011-06-07 04:00:00,4,2,11.51,32.47,49.94,16,88,104
2011-06-07 05:00:00,4,3,34.53,36.85,31.98,40,159,199
2011-06-07 06:00:00,1,4,30.25,40.82,20.73,23,20,43
2011-06-07 07:00:00,4,4,28.67,93.57,43.72,7,13,20
2011-06-07 08:00:00,1,1,14.91,80.75,27.71,5,135,140
2011-06-07 09:00:00,3,3,21.07,64.23,37.47,8,6,14
2011-06-07 10:00:00,1,1,9.11,40.16,29.39,14,98,112
2011-06-07 11:00:00,4,3,21.15,28.87,1.91,23,186,209
2011-06-07 12:00:00,4,1,9.38,91.9,10.66,49,129,178
2011-06-07 13:00:00,3,1,21.59,91.41,3.94,10,68,78
2011-06-07 14:00:00,4,2,24.46,28.86,5.33,30,171,201
2011-06-07 15:00:00,4,1,16.71,83.78,0.77,45,65,110
2011-06-07 16:00:00,2,2,19.96,55.73,21.06,44,17,61
2011-06-07 17:00:00,2,4,31.27,45.92,8.93,44,143,187
2011-06-07 18:00:00,3,3,8.26,79.13,42.78,12,11,23
2011-06-07 19:00:00,1,4,28.75,69.15,37.5,29,107,136
2011-06-07 20:00:00,2,3,10.12,82.4,28.66,24,59,83
2011-06-07 21:00:00,1,4,6.1,25.95,24.45,47,53,100
2011-06-07 22:00:00,4,3,10.57,45.49,12.79,11,39,50
2011-06-07 23:00:00,2,1,27.95,45.55,23.75,20,170,190
2011-06-08 00:00:00,3,3,17.15,46.38,32.06,23,149,172
2011-06-08 01:00:00,3,3,31.18,60.2,39.11,25,3,28
2011-06-08 02:00:00,3,4,20.74,42.64,4.08,49,20,69
2011-06-08 03:00:00,2,4,5.67,55.55,35.42,11,150,161
2011-06-08 04:00:00,1,4,26.5,49.42,37.14,36,169,205
2011-06-08 05:00:00,4,2,8.31,78.82,27.95,48,90,138
2011-06-08 06:00:00,1,2,28.68,68.28,10.72,20,40,60
2011-06-08 07:00:00,1,3,10.04,72.29,26.96,22,143,165
2011-06-08 08:00:00,4,3,15.36,36.85,25.14,0,95,95
2011-06-08 09:00:00,4,1,27.84,46.04,23.79,44,35,79
2011-06-08 10:00:00,2,1,33.63,21.69,23.03,9,121,130
2011-06-08 11:00:00,2,3,16.14,28.67,5.54,34,16,50
2011-06-08 12:00:00,2,2,29.88,41.2,9.14,37,181,218
2011-06-08 13:00:00,2,3,10.72,25.24,4.87,47,90,137
2011-06-08 14:00:00,2,1,29.22,68.21,12.12,27,134,161
2011-06-08 15:00:00,4,2,24.72,99.85,13.17,0,117,117
2011-06-08 16:00:00,1,2,10.78,28.07,12.25,7,168,175
2011-06-08 17:00:00,2,1,14.08,85.7,10.55,40,101,141
2011-06-08 18:00:00,2,3,8.95,29.51,36.77,22,61,83
2011-06-08 19:00:00,1,4,16.49,73.59,40.93,19,117,136
2011-06-08 20:00:00,2,3,11.11,71.45,16.36,31,83,114
2011-06-08 21:00:00,1,3,24.32,92.22,15.26,22,56,78
2011-06-08 22:00:00,1,1,34.84,29.12,42.2,6,98,104
2011-06-08 23:00:00,4,2,5.36,45.24,31.2,10,32,42
2011-06-09 00:00:00,3,1,21.23,27.26,14.67,7,25,32
2011-06-09 01:00:00,4,3,22.21,52.59,35.68,42,87,129
2011-06-09 02:00:00,3,4,32.43,92.93,17.23,13,23,36
2011-06-09 03:00:00,3,4,20.18,82.52,29.33,13,30,43
2011-06-09 04:00:00,3,4,21.31,77.83,49.63,35,26,61
2011-06-09 05:00:00,2,1,19.15,62.64,15.08,40,48,88
2011-06-09 06:00:00,4,2,13.07,90.68,46.53,39,72,111
2011-06-09 07:00:00,3,1,6.68,55.96,16.03,46,193,239
2011-06-09 08:00:00,1,4,17.26,31.97,27.01,26,197,223
2011-06-09 09:00:00,2,3,6.58,87.01,23.0,19,158,177
2011-06-09 10:00:00,4,2,21.51,42.37,39.16,37,152,189
2011-06-09 11:00:00,3,1,14.22,24.29,3.05,24,15,39
2011-06-09 12:00:00,1,1,21.01,30.08,31.36,47,108,155
2011-06-09 13:00:00,4,2,9.03,68.72,38.03,47,133,180
2011-06-09 14:00:00,4,2,32.98,68.57,23.61,28,86,114
2011-06-09 15:00:00,2,3,31.84,40.81,5.26,13,110,123
2011-06-09 16:00:00,4,2,10.7,78.17,12.24,27,120,147
2011-06-09 17:00:00,2,3,15.3,81.89,33.98,29,196,225
2011-06-09 18:00:00,3,4,23.4,93.64,44.77,14,144,158
2011-06-09 19:00:00,2,4,7.87,66.79,21.08,20,8,28
2011-06-09 20:00:00,1,1,15.64,82.35,28.02,11,89,100
2011-06-09 21:00:00,2,4,12.53,80.25,11.42,49,189,238
2011-06-09 22:00:00,1,4,32.47,40.62,20.61,10,12,22
2011-06-09 23:00:00,2,3,30.58,44.82,16.84,38,134,172
2011-06-10 00:00:00,4,1,22.39,58.28,32.78,5,17,22
2011-06-10 01:00:00,3,2,20.61,21.52,49.23,2,100,102
2011-06-10 02:00:00,1,1,32.92,43.79,40.67,40,44,84
2011-06-10 03:00:00,2,4,32.97,57.91,9.61,14,151,165
2011-06-10 04:00:00,2,2,34.08,28.65,28.88,33,182,215
2011-06-10 05:00:00,2,1,8.76,30.1,3.32,3,31,34
2011-06-10 06:00:00,4,1,9.82,57.06,12.35,33,6,39
2011-06-10 07:00:00,4,1,25.3,78.48,8.61,37,19,56
2011-06-10 08:00:00,1,1,21.24,86.7,16.78,43,121,164
2011-06-10 09:00:00,1,3,5.55,63.71,33.94,38,146,184
2011-06-10 10:00:00,4,1,6.86,57.98,24.97,40,109,149
2011-06-10 11:00:00,1,4,31.64,50.74,46.65,5,189,194
2011-06-10 12:00:00,3,4,31.07,35.44,10.64,21,13,34
2011-06-10 13:00:00,3,3,15.72,31.72,18.21,36,159,195
2011-06-10 14:00:00,4,2,31.73,83.35,16.49,31,8,39
2011-06-10 15:00:00,1,2,22.81,57.2,11.8,27,99,126
2011-06-10 16:00:00,2,4,29.18,83.23,49.66,25,176,201
2011-06-10 17:00:00,3,4,17.82,76.33,19.36,3,89,92
2011-06-10 18:00:00,4,3,8.4,35.51,47.03,9,92,101
2011-06-10 19:00:00,1,2,18.01,60.82,19.52,26,15,41
2011-06-10 20:00:00,4,2,18.72,55.52,10.2,19,151,170
2011-06-10 21:00:00,2,1,21.53,53.91,5.96,35,157,192
2011-06-10 22:00:00,3,1,8.17,63.41,42.78,4,135,139
2011-06-10 23:00:00,4,1,34.74,98.57,1.6,16,78,94
2011-06-11 00:00:00,4,3,12.32,85.03,48.22,49,113,162
2011-06-11 01:00:00,4,4,10.96,92.3,20.91,31,137,168
2011-06-11 02:00:00,2,3,20.8,22.37,12.37,34,163,197
2011-06-11 03:00:00,4,2,21.12,31.23,30.87,22,23,45
2011-06-11 04:00:00,2,4,18.19,26.78,6.65,12,135,147
2011-06-11 05:00:00,2,1,28.16,41.06,3.61,0,0,0
2011-06-11 06:00:00,2,3,20.5,55.35,41.39,30,73,103
2011-06-11 07:00:00,3,3,23.29,71.36,21.23,18,110,128
2011-06-11 08:00:00,3,1,26.71,60.07,25.91,22,101,123
2011-06-11 09:00:00,4,3,5.75,92.25,8.83,33,160,193
2011-06-11 10:00:00,4,1,22.12,95.19,3.07,3,30,33
2011-06-11 11:00:00,3,2,31.53,33.08,18.39,47,76,123
2011-06-11 12:00:00,1,4,5.52,88.23,25.31,47,61,108
2011-06-11 13:00:00,3,2,17.16,58.54,38.27,48,34,82
2011-06-11 14:00:00,2,2,32.79,56.27,25.05,43,171,214
2011-06-11 15:00:00,3,1,15.59,82.8,39.13,33,174,207
2011-06-11 16:00:00,2,3,18.76,27.45,5.77,29,159,188
2011-06-11 17:00:00,4,2,34.45,90.6,3.2,9,190,199
2011-06-11 18:00:00,1,2,10.98,73.67,7.94,5,21,26
2011-06-11 19:00:00,4,2,6.96,90.02,38.6,11,134,145
2011-06-11 20:00:00,2,3,30.78,99.56,37.97,11,133,144
2011-06-11 21:00:00,2,3,31.05,61.44,7.07,48,168,216
2011-06-11 22:00:00,2,1,19.16,27.46,1.55,17,11,28
2011-06-11 23:00:00,1,2,20.43,33.32,34.26,35,167,202
2011-06-12 00:00:00,3,4,30.07,45.89,42.76,34,196,230
2011-06-12 01:00:00,4,3,27.16,28.28,37.71,24,185,209
2011-06-12 02:00:00,4,1,12.95,85.23,10.14,48,130,178
2011-06-12 03:00:00,3,2,5.51,43.75,29.19,40,99,139
2011-06-12 04:00:00,4,4,19.39,98.07,37.87,21,42,63
2011-06-12 05:00:00,1,3,30.77,76.21,12.79,29,73,102
2011-06-12 06:00:00,4,4,31.88,33.87,26.39,43,7,50
2011-06-12 07:00:00,2,3,33.69,58.08,15.72,28,140,168
2011-06-12 08:00:00,3,1,31.39,57.35,11.28,6,183,189
2011-06-12 09:00:00,1,4,22.4,59.4,48.48,47,146,193
2011-06-12 10:00:00,3,2,18.34,62.86,45.63,39,22,61
2011-06-12 11:00:00,1,2,28.25,22.49,22.28,2,42,44
2011-06-12 12:00:00,2,3,27.19,74.9,6.84,20,23,43
2011-06-12 13:00:00,3,2,21.14,58.98,36.4,44,130,174
2011-06-12 14:00:00,4,4,7.62,83.28,12.79,19,141,160
2011-06-12 15:00:00,1,1,32.78,85.23,8.43,8,160,168
2011-06-12 16:00:00,3,3,18.67,38.44,19.08,40,86,126
2011-06-12 17:00:00,4,4,15.9,23.87,26.49,35,154,189
2011-06-12 18:00:00,3,3,23.89,76.26,4.87,13,139,152
2011-06-12 19:00:00,3,1,25.22,98.22,28.59,17,45,62
2011-06-12 20:00:00,3,3,11.32,55.73,0.77,32,110,142
2011-06-12 21:00:00,1,2,30.11,40.77,44.59,1,198,199
2011-06-12 22:00:00,4,2,13.7,32.53,46.04,36,45,81
2011-06-12 23:00:00,2,3,10.6,43.0,36.65,30,81,111
2011-06-13 00:00:00,1,1,17.19,46.23,23.33,21,143,164
2011-06-13 01:00:00,1,1,26.92,53.91,12.74,45,57,102
2011-06-13 02:00:00,1,2,33.96,72.43,37.21,8,141,149
2011-06-13 03:00:00,2,1,29.28,41.85,46.59,19,84,103
2011-06-13 04:00:00,4,3,33.21,24.08,7.93,19,170,189
2011-06-13 05:00:00,4,4,9.22,49.86,23.29,46,24,70
2011-06-13 06:00:00,4,3,7.14,88.45,15.76,0,101,101
2011-06-13 07:00:00,3,2,21.73,59.87,17.84,29,142,171
2011-06-13 08:00:00,3,2,13.71,97.18,20.29,18,73,91
2011-06-13 09:00:00,3,2,29.84,60.29,47.59,35,157,192
2011-06-13 10:00:00,2,1,25.16,42.07,12.93,13,43,56
2011-06-13 11:00:00,3,3,34.12,35.47,24.63,0,136,136
2011-06-13 12:00:00,2,4,12.64,75.56,47.57,4,91,95
2011-06-13 13:00:00,4,3,19.57,62.91,23.8,9,81,90
2011-06-13 14:00:00,3,4,20.04,68.32,43.18,8,138,146
2011-06-13 15:00:00,3,3,12.18,80.41,2.94,48,101,149
2011-06-13 16:00:00,1,2,22.7,78.07,47.65,13,65,78
2011-06-13 17:00:00,2,4,18.3,23.47,9.38,38,21,59
2011-06-13 18:00:00,4,3,18.4,84.21,49.0,17,86,103
2011-06-13 19:00:00,1,1,15.88,62.62,8.78,41,147,188
2011-06-13 20:00:00,1,1,5.51,51.34,22.22,24,108,132
2011-06-13 21:00:00,4,3,20.66,63.0,15.43,35,156,191
2011-06-13 22:00:00,1,2,15.06,69.0,21.66,30,89,119
2011-06-13 23:00:00,2,4,5.04,31.96,12.53,45,190,235
2011-06-14 00:00:00,2,3,14.24,53.39,48.27,34,40,74
2011-06-14 01:00:00,3,1,13.36,46.85,15.29,26,122,148
2011-06-14 02:00:00,1,4,16.8,48.03,32.66,21,111,132
2011-06-14 03:00:00,3,1,8.96,27.31,6.87,10,92,102
2011-06-14 04:00:00,1,1,20.23,32.79,41.22,9,82,91
2011-06-14 05:00:00,2,3,25.77,32.95,27.13,7,47,54
2011-06-14 06:00:00,2,1,23.91,49.86,48.97,40,26,66
2011-06-14 07:00:00,2,4,29.11,91.56,21.17,27,93,120
2011-06-14 08:00:00,1,2,18.56,36.48,9.77,22,158,180
2011-06-14 09:00:00,2,3,20.57,53.3,17.3,5,91,96
2011-06-14 10:00:00,1,4,29.31,44.93,36.85,13,152,165
2011-06-14 11:00:00,3,3,17.83,82.99,32.96,23,176,199
2011-06-14 12:00:00,1,1,26.05,24.01,38.92,8,197,205
2011-06-14 13:00:00,3,1,18.04,35.72,3.67,45,191,236
2011-06-14 14:00:00,1,4,17.53,36.85,29.02,39,55,94
2011-06-14 15:00:00,3,4,27.81,99.44,46.61,37,134,171
2011-06-14 16:00:00,2,2,10.25,65.66,5.4,24,69,93
2011-06-14 17:00:00,3,4,15.16,31.12,4.72,37,162,199
2011-06-14 18:00:00,2,4,11.73,41.78,35.83,29,20,49
2011-06-14 19:00:00,2,3,15.77,33.43,15.76,21,46,67
2011-06-14 20:00:00,3,1,11.91,29.97,32.93,1,59,60
2011-06-14 21:00:00,1,4,22.38,83.77,27.27,24,111,135
2011-06-14 22:00:00,1,2,28.95,59.66,49.3,23,144,167
2011-06-14 23:00:00,4,4,28.6,70.5,44.45,36,89,125
2011-06-15 00:00:00,1,1,15.94,46.5,33.9,2,16,18
2011-06-15 01:00:00,4,4,34.66,64.3,13.08,42,198,240
2011-06-15 02:00:00,1,3,22.82,40.61,13.1,25,152,177
2011-06-15 03:00:00,1,1,16.98,44.64,44.11,29,161,190
2011-06-15 04:00:00,2,4,30.07,72.18,29.27,28,25,53
2011-06-15 05:00:00,4,3,26.9,32.03,39.46,6,5,11
2011-06-15 06:00:00,1,1,27.48,69.38,22.49,8,9,17
2011-06-15 07:00:00,4,4,10.88,88.18,5.15,44,80,124
2011-06-15 08:00:00,2,3,19.05,29.63,16.63,29,130,159
2011-06-15 09:00:00,2,2,30.85,91.8,8.06,15,58,73
2011-06-15 10:00:00,4,3,20.12,26.36,39.09,43,111,154
2011-06-15 11:00:00,2,2,25.5,47.91,35.03,39,79,118
2011-06-15 12:00:00,3,4,22.64,68.84,4.42,13,196,209
2011-06-15 13:00:00,3,3,30.27,64.75,31.07,25,47,72
2011-06-15 14:00:00,2,2,13.54,27.71,43.71,45,150,195
2011-06-15 15:00:00,3,1,22.26,83.91,34.87,36,90,126
2011-06-15 16:00:00,1,3,8.7,97.85,25.56,9,132,141
2011-06-15 17:00:00,4,4,25.71,34.5,15.59,29,183,212
2011-06-15 18:00:00,1,1,26.96,91.61,44.35,21,165,186
2011-06-15 19:00:00,4,2,6.29,64.54,21.14,29,75,104
2011-06-15 20:00:00,2,3,25.27,94.87,42.77,31,84,115
2011-06-15 21:00:00,1,3,17.44,34.09,39.15,13,6,19
2011-06-15 22:00:00,2,4,8.72,83.36,40.81,22,144,166
2011-06-15 23:00:00,2,1,17.6,24.78,49.49,16,8,24
2011-06-16 00:00:00,4,3,10.83,90.66,37.44,35,88,123
2011-06-16 01:00:00,4,3,17.47,73.93,1.7,28,173,201
2011-06-16 02:00:00,4,1,16.53,49.62,10.27,23,36,59
2011-06-16 03:00:00,1,3,27.15,35.24,1.76,46,134,180
2011-06-16 04:00:00,3,1,28.23,85.32,9.5,10,16,26
2011-06-16 05:00:00,4,1,23.21,68.26,3.07,40,118,158
2011-06-16 06:00:00,4,1,5.68,48.83,25.08,14,40,54
2011-06-16 07:00:00,1,4,32.93,55.51,1.41,21,63,84
2011-06-16 08:00:00,4,1,25.59,86.12,23.63,26,82,108
2011-06-16 09:00:00,1,1,6.03,47.11,44.94,33,56,89
2011-06-16 10:00:00,2,2,29.56,27.17,37.43,32,44,76
2011-06-16 11:00:00,4,2,11.01,92.9,47.2,20,72,92
2011-06-16 12:00:00,4,4,22.38,50.99,11.33,23,108,131
2011-06-16 13:00:00,2,1,19.0,47.87,26.55,19,109,128
2011-06-16 14:00:00,2,2,17.6,36.35,15.93,48,135,183
2011-06-16 15:00:00,2,2,31.69,91.79,24.69,3,109,112
2011-06-16 16:00:00,4,3,18.12,37.4,27.85,36,108,144
2011-06-16 17:00:00,3,1,7.26,70.93,1.81,36,90,126
2011-06-16 18:00:00,3,2,33.4,90.46,11.66,45,86,131
2011-06-16 19:00:00,3,4,32.62,22.79,35.24,32,137,169
2011-06-16 20:00:00,4,3,25.53,86.3,38.65,30,181,211
2011-06-16 21:00:00,2,3,19.04,52.85,28.47,33,193,226
2011-06-16 22:00:00,4,1,7.79,72.64,13.54,21,43,64
2011-06-16 23:00:00,2,1,28.72,49.79,20.25,41,47,88
2011-06-17 00:00:00,4,3,7.26,75.64,4.8,29,70,99
2011-06-17 01:00:00,4,4,7.06,40.34,47.66,4,1,5
2011-06-17 02:00:00,2,1,21.12,21.75,43.43,40,79,119
2011-06-17 03:00:00,3,1,9.8,95.82,3.28,44,117,161
2011-06-17 04:00:00,2,3,5.23,21.31,8.32,22,5,27
2011-06-17 05:00:00,1,3,17.69,85.93,29.05,12,79,91
2011-06-17 06:00:00,1,1,9.12,33.53,11.62,8,88,96
2011-06-17 07:00:00,2,2,9.82,51.38,46.72,13,44,57
2011-06-17 08:00:00,4,1,7.31,85.8,37.78,16,9,25
2011-06-17 09:00:00,1,2,11.15,36.47,13.66,34,136,170
2011-06-17 10:00:00,1,3,26.46,89.26,0.31,17,31,48
2011-06-17 11:00:00,4,2,29.27,59.82,39.97,11,1,12
2011-06-17 12:00:00,4,4,18.58,49.29,21.2,40,20,60
2011-06-17 13:00:00,3,3,20.2,73.0,32.12,15,130,145
2011-06-17 14:00:00,4,1,5.98,47.31,14.35,29,92,121
2011-06-17 15:00:00,2,1,7.08,47.78,7.14,12,120,132
2011-06-17 16:00:00,2,3,12.73,78.68,33.77,17,22,39
2011-06-17 17:00:00,3,3,21.32,44.79,22.52,11,164,175
2011-06-17 18:00:00,1,4,27.19,36.06,11.76,33,199,232
2011-06-17 19:00:00,1,3,23.15,84.61,6.88,32,35,67
2011-06-17 20:00:00,4,1,16.76,84.43,29.02,5,13,18
2011-06-17 21:00:00,2,4,8.55,59.81,36.28,17,14,31
2011-06-17 22:00:00,1,1,28.42,62.13,14.19,2,34,36
2011-06-17 23:00:00,3,2,15.91,75.69,36.76,5,119,124
2011-06-18 00:00:00,3,3,27.08,60.74,9.16,35,21,56
2011-06-18 01:00:00,2,2,20.39,53.36,16.92,48,174,222
2011-06-18 02:00:00,3,1,27.16,99.59,37.24,49,35,84
2011-06-18 03:00:00,3,2,32.22,31.81,33.01,21,14,35
2011-06-18 04:00:00,2,2,32.63,67.42,13.53,6,120,126
2011-06-18 05:00:00,4,1,21.05,90.87,6.11,29,95,124
2011-06-18 06:00:00,4,1,20.35,74.98,2.12,1,185,186
2011-06-18 07:00:00,3,3,12.97,90.47,41.9,31,158,189
2011-06-18 08:00:00,4,2,33.07,46.91,3.76,14,168,182
2011-06-18 09:00:00,4,4,18.74,41.76,5.74,21,99,120
2011-06-18 10:00:00,3,4,8.83,88.1,11.89,48,88,136
2011-06-18 11:00:00,4,1,17.98,51.53,22.28,37,73,110
2011-06-18 12:00:00,3,1,8.81,76.77,39.49,7,25,32
2011-06-18 13:00:00,1,2,20.08,31.82,12.37,7,29,36
2011-06-18 14:00:00,2,1,21.84,80.47,27.18,38,121,159
2011-06-18 15:00:00,2,4,15.13,63.92,4.52,35,102,137
2011-06-18 16:00:00,4,3,7.15,41.49,23.23,19,139,158
2011-06-18 17:00:00,4,3,33.31,59.56,8.88,36,30,66
2011-06-18 18:00:00,4,2,28.2,75.76,10.56,7,108,115
2011-06-18 19:00:00,2,3,30.17,20.95,18.34,13,110,123
2011-06-18 20:00:00,1,1,16.01,71.0,38.07,19,110,129
2011-06-18 21:00:00,1,1,27.82,63.33,37.2,34,81,115
2011-06-18 22:00:00,2,1,19.56,37.62,20.75,24,1,25
2011-06-18 23:00:00,1,1,11.03,80.24,5.93,17,77,94
2011-06-19 00:00:00,2,2,8.73,44.28,14.03,46,147,193
2011-06-19 01:00:00,1,3,15.35,42.15,25.27,20,185,205
2011-06-19 02:00:00,3,4,9.13,57.7,43.47,36,147,183
2011-06-19 03:00:00,3,3,34.95,74.09,48.41,46,33,79
2011-06-19 04:00:00,2,1,6.48,94.31,31.87,30,59,89
2011-06-19 05:00:00,1,4,18.23,31.31,17.53,5,33,38
2011-06-19 06:00:00,4,2,18.56,51.72,34.67,41,164,205
2011-06-19 07:00:00,1,1,14.02,25.36,16.81,46,194,240
2011-06-19 08:00:00,3,1,22.14,80.68,31.27,19,126,145
2011-06-19 09:00:00,3,4,9.5,55.82,12.19,27,18,45
2011-06-19 10:00:00,1,2,28.52,76.55,13.35,40,51,91
2011-06-19 11:00:00,1,4,14.97,45.78,3.76,35,43,78
2011-06-19 12:00:00,4,2,22.74,87.55,21.01,39,85,124
2011-06-19 13:00:00,4,1,26.47,62.79,30.91,25,154,179
2011-06-19 14:00:00,1,3,31.67,95.49,39.44,12,37,49
2011-06-19 15:00:00,1,1,30.07,26.31,40.52,48,91,139
2011-06-19 16:00:00,1,3,23.25,61.14,49.62,3,148,151
2011-06-19 17:00:00,1,3,16.65,81.32,4.39,33,165,198
2011-06-19 18:00:00,2,2,20.1,68.01,24.66,36,12,48
2011-06-19 19:00:00,1,4,28.06,21.86,26.07,33,92,125
2011-06-19 20:00:00,4,2,31.33,97.79,40.23,15,148,163
2011-06-19 21:00:00,3,1,8.11,43.86,13.32,22,41,63
2011-06-19 22:00:00,2,4,16.55,39.94,3.47,22,95,117
2011-06-19 23:00:00,1,3,28.28,58.85,15.69,14,47,61
2011-06-20 00:00:00,3,3,17.95,63.37,49.2,24,45,69
2011-06-20 01:00:00,2,1,14.97,81.3,44.97,28,113,141
2011-06-20 02:00:00,3,4,17.34,51.46,19.76,35,77,112
2011-06-20 03:00:00,1,1,23.09,55.2,43.81,14,56,70
2011-06-20 04:00:00,1,1,34.99,62.8,1.64,36,51,87
2011-06-20 05:00:00,4,2,19.79,51.55,15.71,34,21,55
2011-06-20 06:00:00,1,1,11.25,93.16,36.34,45,16,61
2011-06-20 07:00:00,1,4,9.89,88.1,11.07,38,96,134
2011-06-20 08:00:00,2,1,6.27,56.4,9.92,46,101,147
2011-06-20 09:00:00,4,4,21.76,20.02,43.09,36,25,61
2011-06-20 10:00:00,2,3,21.34,92.07,30.8,40,166,206
2011-06-20 11:00:00,3,1,11.16,29.95,49.45,27,70,97
2011-06-20 12:00:00,1,4,25.86,39.56,6.73,44,190,234
2011-06-20 13:00:00,3,3,27.23,32.19,17.81,29,178,207
2011-06-20 14:00:00,2,4,12.77,34.39,15.56,6,157,163
2011-06-20 15:00:00,1,3,15.32,84.23,44.01,3,40,43
2011-06-20 16:00:00,1,2,34.71,66.36,12.76,6,160,166
2011-06-20 17:00:00,2,1,16.23,96.49,17.67,32,49,81
2011-06-20 18:00:00,2,1,27.82,38.52,7.14,46,190,236
2011-06-20 19:00:00,2,3,18.58,58.85,38.77,46,166,212
2011-06-20 20:00:00,2,2,28.8,98.19,11.89,17,27,44
2011-06-20 21:00:00,2,4,28.07,86.12,3.42,14,145,159
2011-06-20 22:00:00,1,2,25.03,78.29,21.76,34,73,107
2011-06-20 23:00:00,2,4,30.64,35.12,19.57,36,186,222
2011-06-21 00:00:00,1,4,33.18,81.55,8.88,4,127,131
2011-06-21 01:00:00,1,1,22.4,47.81,6.68,47,65,112
2011-06-21 02:00:00,2,3,12.12,62.44,44.83,22,113,135
2011-06-21 03:00:00,2,1,16.96,68.73,3.39,9,170,179
2011-06-21 04:00:00,4,1,27.75,68.75,4.97,24,12,36
2011-06-21 05:00:00,1,1,24.53,78.12,12.25,21,0,21
2011-06-21 06:00:00,2,4,10.33,72.94,47.64,30,159,189
2011-06-21 07:00:00,2,1,6.54,25.47,4.27,22,88,110
2011-06-21 08:00:00,2,4,25.49,56.59,40.8,27,9,36
2011-06-21 09:00:00,4,3,12.53,73.12,44.6,44,142,186
2011-06-21 10:00:00,4,4,19.99,43.68,18.89,14,126,140
2011-06-21 11:00:00,3,4,27.4,45.04,14.69,39,144,183
2011-06-21 12:00:00,1,2,21.88,29.97,33.87,6,190,196
2011-06-21 13:00:00,3,1,7.5,53.49,35.13,45,53,98
2011-06-21 14:00:00,2,1,10.57,98.95,39.0,37,150,187
2011-06-21 15:00:00,4,1,11.58,42.83,41.53,39,70,109
2011-06-21 16:00:00,4,1,12.74,62.51,13.42,14,49,63
2011-06-21 17:00:00,3,2,21.96,79.46,34.35,48,58,106
2011-06-21 18:00:00,4,2,20.12,21.08,6.75,4,163,167
2011-06-21 19:00:00,2,2,11.09,92.04,25.54,11,5,16
2011-06-21 20:00:00,4,2,7.03,50.92,30.64,12,193,205
2011-06-21 21:00:00,3,1,10.14,89.53,8.09,2,108,110
2011-06-21 22:00:00,2,4,34.53,23.12,3.83,18,31,49
2011-06-21 23:00:00,3,3,19.06,31.65,9.74,25,52,77
2011-06-22 00:00:00,4,2,31.02,45.8,21.03,29,107,136
2011-06-22 01:00:00,3,4,30.46,47.64,44.39,27,68,95
2011-06-22 02:00:00,3,2,20.35,87.82,26.6,14,82,96
2011-06-22 03:00:00,1,1,26.2,20.9,37.42,17,1,18
2011-06-22 04:00:00,4,1,10.78,71.29,8.71,6,42,48
2011-06-22 05:00:00,4,4,25.65,30.5,5.3,13,39,52
2011-06-22 06:00:00,3,4,13.17,85.86,11.98,23,195,218
2011-06-22 07:00:00,1,4,29.96,82.29,15.69,23,3,26
2011-06-22 08:00:00,4,1,7.51,59.99,27.41,10,74,84
2011-06-22 09:00:00,2,1,28.19,37.01,44.06,38,173,211
2011-06-22 10:00:00,3,3,8.0,70.76,21.3,42,104,146
2011-06-22 11:00:00,4,4,31.44,32.5,25.94,39,147,186
2011-06-22 12:00:00,2,3,14.13,35.2,0.23,9,121,130
2011-06-22 13:00:00,4,2,24.63,70.14,1.67,42,13,55
2011-06-22 14:00:00,2,3,19.63,99.3,4.19,32,98,130
2011-06-22 15:00:00,3,2,15.99,91.28,34.95,19,108,127
2011-06-22 16:00:00,4,2,24.36,67.45,24.31,41,141,182
2011-06-22 17:00:00,4,3,33.43,63.08,9.65,38,176,214
2011-06-22 18:00:00,1,4,6.24,99.87,29.63,21,130,151
2011-06-22 19:00:00,3,2,32.57,63.79,27.23,34,20,54
2011-06-22 20:00:00,2,4,23.27,53.61,4.44,27,60,87
2011-06-22 21:00:00,4,1,29.22,92.76,32.02,35,1,36
2011-06-22 22:00:00,4,2,16.52,38.73,38.36,29,148,177
2011-06-22 23:00:00,2,1,19.16,27.8,14.33,5,9,14
2011-06-23 00:00:00,3,3,31.07,70.73,34.37,0,90,90
2011-06-23 01:00:00,1,4,17.45,27.67,9.99,3,117,120
2011-06-23 02:00:00,1,3,21.04,49.85,37.84,24,146,170
2011-06-23 03:00:00,4,2,5.61,53.89,45.59,38,180,218
2011-06-23 04:00:00,2,1,9.76,63.8,22.09,10,75,85
2011-06-23 05:00:00,4,2,24.25,99.33,12.23,37,176,213
2011-06-23 06:00:00,2,3,26.51,37.68,19.96,36,79,115
2011-06-23 07:00:00,1,4,22.48,50.06,12.5,11,7,18
2011-06-23 08:00:00,3,4,9.3,30.58,0.06,28,184,212
2011-06-23 09:00:00,2,2,18.36,68.61,32.52,33,100,133
2011-06-23 10:00:00,1,2,15.65,78.21,2.13,17,88,105
2011-06-23 11:00:00,4,1,19.87,58.57,10.52,8,151,159
2011-06-23 12:00:00,2,3,31.11,39.67,36.12,45,46,91
2011-06-23 13:00:00,3,2,28.28,69.67,33.29,11,81,92
2011-06-23 14:00:00,4,1,7.52,63.13,3.67,8,148,156
2011-06-23 15:00:00,4,2,31.71,33.69,33.0,0,123,123
2011-06-23 16:00:00,1,4,19.15,52.45,46.53,6,7,13
2011-06-23 17:00:00,2,1,27.32,54.82,3.73,38,146,184
2011-06-23 18:00:00,4,1,9.2,98.61,20.78,41,29,70
2011-06-23 19:00:00,3,2,25.12,87.94,36.47,33,90,123
2011-06-23 20:00:00,2,3,12.09,78.75,33.39,31,153,184
2011-06-23 21:00:00,3,4,18.15,91.1,11.33,27,147,174
2011-06-23 22:00:00,4,3,5.51,78.84,8.15,25,115,140
2011-06-23 23:00:00,3,1,9.55,92.27,39.21,35,104,139
2011-06-24 00:00:00,1,3,7.76,24.36,47.81,39,77,116
2011-06-24 01:00:00,3,1,12.19,56.49,38.38,13,172,185
2011-06-24 02:00:00,2,3,8.0,79.75,48.16,44,63,107
2011-06-24 03:00:00,3,2,25.76,66.66,30.25,30,29,59
2011-06-24 04:00:00,3,3,5.87,34.01,46.45,15,180,195
2011-06-24 05:00:00,1,1,23.53,47.24,34.52,38,177,215
2011-06-24 06:00:00,3,4,9.22,45.42,45.44,41,189,230
2011-06-24 07:00:00,3,4,33.35,40.91,8.08,10,169,179
2011-06-24 08:00:00,4,4,32.99,47.45,40.78,10,155,165
2011-06-24 09:00:00,4,1,11.77,61.19,9.84,37,57,94
2011-06-24 10:00:00,2,3,23.43,88.39,1.37,11,30,41
2011-06-24 11:00:00,4,4,5.84,79.36,25.88,41,89,130
2011-06-24 12:00:00,4,4,32.95,86.82,15.91,8,99,107
2011-06-24 13:00:00,4,4,20.69,90.69,2.18,21,127,148
2011-06-24 14:00:00,4,2,6.3,53.29,49.02,37,58,95
2011-06-24 15:00:00,1,1,15.27,47.68,33.32,8,110,118
2011-06-24 16:00:00,4,1,7.31,24.61,45.09,2,115,117
2011-06-24 17:00:00,1,1,16.79,94.44,49.95,38,11,49
2011-06-24 18:00:00,1,1,25.1,25.27,19.6,34,44,78
2011-06-24 19:00:00,4,1,19.1,79.29,12.74,29,65,94
2011-06-24 20:00:00,3,2,16.51,50.25,9.19,25,103,128
2011-06-24 21:00:00,1,3,8.57,95.9,25.76,7,195,202
2011-06-24 22:00:00,3,2,12.35,53.57,30.3,31,159,190
2011-06-24 23:00:00,3,4,8.0,85.33,23.62,21,168,189
2011-06-25 00:00:00,4,2,29.22,42.61,19.36,7,97,104
2011-06-25 01:00:00,2,1,9.06,43.93,8.41,44,182,226
2011-06-25 02:00:00,4,2,22.86,67.64,22.09,1,68,69
2011-06-25 03:00:00,2,1,15.28,99.84,4.26,13,4,17
2011-06-25 04:00:00,2,2,11.78,61.41,43.25,4,62,66
2011-06-25 05:00:00,4,1,24.18,94.9,2.35,12,3,15
2011-06-25 06:00:00,4,4,18.71,82.9,19.03,22,114,136
2011-06-25 07:00:00,2,1,17.0,83.67,5.01,12,40,52
2011-06-25 08:00:00,4,2,22.79,54.88,38.75,18,139,157
2011-06-25 09:00:00,2,4,19.74,50.92,15.64,23,164,187
2011-06-25 10:00:00,3,2,14.1,35.35,5.66,34,97,131
2011-06-25 11:00:00,4,4,21.77,97.12,26.57,13,54,67
2011-06-25 12:00:00,3,3,25.08,96.75,45.81,3,44,47
2011-06-25 13:00:00,1,3,5.8,79.77,45.43,25,155,180
2011-06-25 14:00:00,3,3,18.98,43.7,12.48,9,58,67
2011-06-25 15:00:00,3,2,6.73,39.61,35.98,37,134,171
2011-06-25 16:00:00,2,2,10.59,99.09,1.51,37,187,224
2011-06-25 17:00:00,3,4,21.82,25.32,6.59,33,180,213
2011-06-25 18:00:00,4,4,30.99,87.49,24.97,33,167,200
2011-06-25 19:00:00,2,4,31.48,48.44,11.44,18,120,138
2011-06-25 20:00:00,1,4,7.1,53.51,39.91,2,124,126
2011-06-25 21:00:00,4,1,17.57,86.56,46.55,35,51,86
2011-06-25 22:00:00,1,3,22.49,27.25,0.22,3,10,13
2011-06-25 23:00:00,3,1,9.41,48.33,11.65,25,95,120
2011-06-26 00:00:00,4,1,27.96,96.16,21.98,10,177,187
2011-06-26 01:00:00,4,1,27.33,75.93,28.15,2,49,51
2011-06-26 02:00:00,1,1,32.1,80.4,45.8,48,95,143
2011-06-26 03:00:00,4,3,5.25,80.6,44.59,8,122,130
2011-06-26 04:00:00,4,1,11.5,24.85,31.86,45,47,92
2011-06-26 05:00:00,4,4,29.82,36.26,12.87,1,181,182
2011-06-26 06:00:00,3,2,25.12,59.3,39.16,13,133,146
2011-06-26 07:00:00,1,4,31.83,49.45,10.13,2,49,51
2011-06-26 08:00:00,4,2,6.72,52.87,48.26,1,81,82
2011-06-26 09:00:00,2,4,22.91,82.52,0.29,21,130,151
2011-06-26 10:00:00,2,4,22.07,21.17,28.49,28,40,68
2011-06-26 11:00:00,2,2,6.07,72.84,4.42,32,27,59
2011-06-26 12:00:00,2,3,20.41,20.01,20.38,35,159,194
2011-06-26 13:00:00,3,1,23.29,25.04,31.75,9,166,175
2011-06-26 14:00:00,4,4,10.74,52.66,34.48,46,198,244
2011-06-26 15:00:00,1,3,13.2,87.28,39.28,43,190,233
2011-06-26 16:00:00,4,1,24.21,31.6,29.67,37,146,183
2011-06-26 17:00:00,3,3,19.05,64.37,12.57,20,128,148
2011-06-26 18:00:00,2,3,30.74,74.28,44.46,30,160,190
2011-06-26 19:00:00,3,1,15.27,38.36,40.56,34,32,66
2011-06-26 20:00:00,4,4,13.0,60.99,8.0,2,10,12
2011-06-26 21:00:00,1,3,34.55,92.91,41.33,18,187,205
2011-06-26 22:00:00,3,4,32.33,60.98,48.63,21,27,48
2011-06-26 23:00:00,1,4,5.87,32.59,31.86,19,189,208
2011-06-27 00:00:00,3,4,28.12,70.23,14.09,35,46,81
2011-06-27 01:00:00,1,1,8.31,67.38,30.33,18,144,162
2011-06-27 02:00:00,1,2,5.82,22.16,17.13,45,73,118
2011-06-27 03:00:00,2,4,13.21,27.25,33.8,3,71,74
2011-06-27 04:00:00,1,2,13.08,32.54,27.24,31,136,167
2011-06-27 05:00:00,2,2,29.58,30.9,46.47,7,82,89
2011-06-27 06:00:00,4,3,26.32,40.76,30.9,25,113,138
2011-06-27 07:00:00,4,4,34.45,56.33,10.7,0,7,7
2011-06-27 08:00:00,2,4,26.35,49.74,36.26,25,186,211
2011-06-27 09:00:00,2,4,17.55,91.25,15.04,46,68,114
2011-06-27 10:00:00,3,2,25.97,68.97,13.62,42,77,119
2011-06-27 11:00:00,3,1,34.98,90.09,19.59,8,44,52
2011-06-27 12:00:00,3,2,26.3,62.16,0.6,34,160,194
2011-06-27 13:00:00,4,4,27.85,27.19,48.46,17,106,123
2011-06-27 14:00:00,3,4,33.15,57.06,26.62,18,37,55
2011-06-27 15:00:00,1,4,8.41,85.76,38.67,47,190,237
2011-06-27 16:00:00,1,2,26.14,35.53,12.89,15,139,154
2011-06-27 17:00:00,3,4,30.52,27.3,37.33,27,66,93
2011-06-27 18:00:00,1,3,33.63,46.35,28.36,2,103,105
2011-06-27 19:00:00,4,4,11.33,51.11,21.21,17,156,173
2011-06-27 20:00:00,1,1,20.12,44.5,48.53,12,149,161
2011-06-27 21:00:00,4,3,25.42,30.82,24.69,26,161,187
2011-06-27 22:00:00,2,4,12.42,40.07,32.87,39,69,108
2011-06-27 23:00:00,2,3,23.01,74.58,0.77,38,98,136
2011-06-28 00:00:00,2,4,12.73,50.87,15.07,23,166,189
2011-06-28 01:00:00,2,1,15.0,70.6,44.43,28,143,171
2011-06-28 02:00:00,1,4,18.25,62.9,37.95,21,158,179
2011-06-28 03:00:00,3,3,20.88,63.92,26.84,25,176,201
2011-06-28 04:00:00,1,1,18.48,39.88,45.01,19,43,62
2011-06-28 05:00:00,4,2,19.8,61.72,24.31,23,45,68
2011-06-28 06:00:00,1,1,13.96,21.89,28.33,11,128,139
2011-06-28 07:00:00,1,1,9.77,54.54,19.11,17,121,138
2011-06-28 08:00:00,4,1,6.42,65.81,31.0,46,43,89
2011-06-28 09:00:00,2,3,10.88,34.56,15.95,11,83,94
2011-06-28 10:00:00,2,1,22.46,40.52,19.27,37,86,123
2011-06-28 11:00:00,2,4,28.58,37.56,48.32,31,83,114
2011-06-28 12:00:00,3,1,10.08,25.64,5.57,48,95,143
2011-06-28 13:00:00,4,1,8.26,47.83,5.26,22,45,67
2011-06-28 14:00:00,4,4,27.48,98.32,2.17,3,71,74
2011-06-28 15:00:00,1,4,14.15,48.31,16.0,11,180,191
2011-06-28 16:00:00,3,2,33.54,56.84,19.91,16,160,176
2011-06-28 17:00:00,2,1,26.43,72.25,4.73,20,172,192
2011-06-28 18:00:00,3,3,14.8,71.88,27.46,36,191,227
2011-06-28 19:00:00,4,1,13.69,95.99,29.17,28,93,121
2011-06-28 20:00:00,4,1,20.71,88.61,37.55,5,130,135
2011-06-28 21:00:00,1,4,7.37,83.52,48.8,46,151,197
2011-06-28 22:00:00,1,2,8.53,96.13,30.97,27,158,185
2011-06-28 23:00:00,4,1,10.28,38.46,5.58,7,70,77
2011-06-29 00:00:00,2,3,28.24,69.36,4.43,30,39,69
2011-06-29 01:00:00,2,1,20.42,90.98,38.88,19,177,196
2011-06-29 02:00:00,3,3,5.32,69.93,32.52,15,73,88
2011-06-29 03:00:00,4,4,25.21,98.19,8.1,12,14,26
2011-06-29 04:00:00,4,2,17.71,28.03,12.67,14,118,132
2011-06-29 05:00:00,2,1,20.33,55.15,37.51,12,20,32
2011-06-29 06:00:00,2,2,11.42,98.19,28.31,46,20,66
2011-06-29 07:00:00,4,1,21.55,50.37,29.25,1,59,60
2011-06-29 08:00:00,1,3,34.37,79.16,10.5,19,105,124
2011-06-29 09:00:00,4,2,7.2,22.43,31.45,27,64,91
2011-06-29 10:00:00,4,1,13.52,75.59,38.53,17,148,165
2011-06-29 11:00:00,2,4,12.29,94.77,44.26,6,182,188
2011-06-29 12:00:00,2,3,12.46,50.62,36.84,20,68,88
2011-06-29 13:00:00,1,2,16.36,21.7,28.82,40,109,149
2011-06-29 14:00:00,1,1,29.54,22.23,33.66,38,25,63
2011-06-29 15:00:00,3,2,32.39,91.36,24.26,8,74,82
2011-06-29 16:00:00,4,1,11.07,77.8,11.34,43,54,97
2011-06-29 17:00:00,2,3,21.29,28.53,44.11,9,112,121
2011-06-29 18:00:00,1,4,24.11,24.37,26.63,30,45,75
2011-06-29 19:00:00,3,3,20.65,84.39,29.72,41,189,230
2011-06-29 20:00:00,3,2,18.02,84.79,49.51,12,69,81
2011-06-29 21:00:00,2,2,10.76,29.64,49.25,4,181,185
2011-06-29 22:00:00,2,1,19.65,44.12,29.32,39,131,170
2011-06-29 23:00:00,3,3,17.04,82.4,1.7,41,172,213
2011-06-30 00:00:00,1,1,28.87,62.03,19.81,37,53,90
2011-06-30 01:00:00,3,3,27.91,96.53,46.86,42,180,222
2011-06-30 02:00:00,4,2,9.02,58.49,14.42,35,171,206
2011-06-30 03:00:00,4,1,7.66,74.16,49.96,1,86,87
2011-06-30 04:00:00,2,1,32.24,60.78,4.22,5,95,100
2011-06-30 05:00:00,1,3,21.07,95.44,28.41,12,119,131
2011-06-30 06:00:00,1,4,30.73,51.89,25.77,28,35,63
2011-06-30 07:00:00,4,3,6.74,38.38,12.77,43,33,76
2011-06-30 08:00:00,3,4,20.8,46.13,47.43,13,179,192
2011-06-30 09:00:00,2,3,21.18,88.22,30.96,29,133,162
2011-06-30 10:00:00,3,2,30.82,59.84,11.51,24,165,189
2011-06-30 11:00:00,3,1,7.93,48.34,19.2,39,85,124
2011-06-30 12:00:00,3,3,12.21,63.54,36.06,34,32,66
2011-06-30 13:00:00,1,2,17.2,30.66,14.88,36,54,90
2011-06-30 14:00:00,4,3,30.98,20.43,43.98,6,22,28
2011-06-30 15:00:00,1,1,33.17,42.45,8.28,49,124,173
2011-06-30 16:00:00,4,3,34.78,68.4,13.23,37,43,80
2011-06-30 17:00:00,2,4,33.78,76.93,7.24,17,99,116
2011-06-30 18:00:00,2,1,5.18,86.13,5.21,7,27,34
2011-06-30 19:00:00,3,4,6.43,94.13,15.02,6,63,69
2011-06-30 20:00:00,4,2,9.43,52.97,49.96,33,47,80
2011-06-30 21:00:00,4,2,15.47,79.24,4.72,35,58,93
2011-06-30 22:00:00,4,3,29.9,25.97,10.65,40,58,98
2011-06-30 23:00:00,3,4,31.78,24.6,13.58,47,42,89
2011-07-01 00:00:00,3,4,10.61,29.98,30.96,9,170,179
2011-07-01 01:00:00,2,1,23.59,55.89,37.27,39,140,179
2011-07-01 02:00:00,1,4,32.52,36.9,37.6,28,71,99
2011-07-01 03:00:00,4,4,18.91,42.95,0.43,15,42,57
2011-07-01 04:00:00,4,1,8.11,71.83,32.59,24,12,36
2011-07-01 05:00:00,1,1,18.73,48.68,31.54,28,162,190
2011-07-01 06:00:00,4,4,16.27,64.59,25.88,7,138,145
2011-07-01 07:00:00,3,3,22.33,52.99,18.96,19,148,167
2011-07-01 08:00:00,3,1,18.16,33.52,39.87,35,199,234
2011-07-01 09:00:00,4,1,5.52,25.92,17.19,26,105,131
2011-07-01 10:00:00,3,4,34.82,38.9,11.5,12,153,165
2011-07-01 11:00:00,3,4,21.31,24.62,15.5,25,93,118
2011-07-01 12:00:00,4,1,19.21,69.49,21.98,41,49,90
2011-07-01 13:00:00,2,4,33.64,83.66,10.7,24,48,72
2011-07-01 14:00:00,1,1,9.68,47.18,30.38,27,102,129
2011-07-01 15:00:00,3,3,10.68,50.97,44.21,8,89,97
2011-07-01 16:00:00,2,3,29.24,85.3,29.77,25,90,115
2011-07-01 17:00:00,3,1,12.82,37.81,22.33,11,85,96
2011-07-01 18:00:00,3,1,28.98,29.53,39.84,25,12,37
2011-07-01 19:00:00,1,2,13.15,60.09,37.4,46,166,212
2011-07-01 20:00:00,3,2,6.0,71.7,18.35,21,182,203
2011-07-01 21:00:00,1,4,20.51,67.97,30.21,0,6,6
2011-07-01 22:00:00,1,4,10.9,77.11,36.49,11,170,181
2011-07-01 23:00:00,1,1,27.74,24.54,12.27,23,41,64
2011-07-02 00:00:00,2,1,24.24,54.26,18.31,29,185,214
2011-07-02 01:00:00,4,2,32.71,39.09,5.29,13,139,152
2011-07-02 02:00:00,2,2,28.49,80.73,49.38,22,12,34
2011-07-02 03:00:00,4,1,10.42,89.82,4.29,1,11,12
2011-07-02 04:00:00,4,3,29.0,42.51,8.43,2,37,39
2011-07-02 05:00:00,1,3,24.25,27.62,23.99,5,2,7
2011-07-02 06:00:00,3,4,25.07,40.27,43.26,18,199,217
2011-07-02 07:00:00,1,1,29.97,28.32,17.79,20,61,81
2011-07-02 08:00:00,3,1,22.21,45.79,38.43,44,158,202
2011-07-02 09:00:00,4,4,18.98,63.06,33.8,19,199,218
2011-07-02 10:00:00,1,2,24.1,97.89,31.93,20,36,56
2011-07-02 11:00:00,3,2,13.94,51.95,42.25,39,23,62
2011-07-02 12:00:00,2,3,10.48,37.6,0.71,3,91,94
2011-07-02 13:00:00,3,1,23.5,33.34,46.46,24,67,91
2011-07-02 14:00:00,1,2,12.02,33.84,41.46,6,63,69
2011-07-02 15:00:00,2,3,7.4,35.41,46.89,6,143,149
2011-07-02 16:00:00,3,3,5.02,80.98,39.68,32,17,49
2011-07-02 17:00:00,3,3,23.25,24.88,43.93,25,67,92
2011-07-02 18:00:00,3,2,15.86,99.79,10.15,16,167,183
2011-07-02 19:00:00,3,2,27.57,61.81,15.96,7,57,64
2011-07-02 20:00:00,3,1,16.26,63.54,15.76,25,122,147
2011-07-02 21:00:00,2,1,19.58,48.61,5.46,14,44,58
2011-07-02 22:00:00,4,3,17.21,75.22,36.48,19,52,71
2011-07-02 23:00:00,2,3,24.52,57.72,6.81,18,26,44
2011-07-03 00:00:00,2,2,15.68,46.32,2.63,6,117,123
2011-07-03 01:00:00,2,2,33.91,41.21,38.77,44,35,79
2011-07-03 02:00:00,4,1,33.08,94.05,45.23,0,195,195
2011-07-03 03:00:00,1,1,30.44,43.28,38.21,38,99,137
2011-07-03 04:00:00,4,4,32.61,54.91,41.27,36,140,176
2011-07-03 05:00:00,2,1,18.47,48.03,29.78,17,178,195
2011-07-03 06:00:00,3,2,21.09,26.89,44.39,7,175,182
2011-07-03 07:00:00,3,3,27.26,34.87,24.84,14,187,201
2011-07-03 08:00:00,2,4,25.88,35.16,49.42,49,105,154
2011-07-03 09:00:00,3,1,31.72,75.49,5.17,5,100,105
2011-07-03 10:00:00,2,1,26.49,52.53,40.46,36,110,146
2011-07-03 11:00:00,3,2,34.94,82.56,32.07,21,197,218
2011-07-03 12:00:00,4,4,15.46,76.72,29.03,10,178,188
2011-07-03 13:00:00,1,1,29.99,35.36,36.29,25,13,38
2011-07-03 14:00:00,1,3,25.93,65.03,42.01,7,170,177
2011-07-03 15:00:00,4,2,25.74,79.43,43.14,8,2,10
2011-07-03 16:00:00,4,4,14.78,70.64,8.77,12,152,164
2011-07-03 17:00:00,2,1,28.57,68.0,9.85,2,33,35
2011-07-03 18:00:00,2,1,32.01,79.17,0.81,2,197,199
2011-07-03 19:00:00,2,4,11.56,24.54,6.59,6,183,189
2011-07-03 20:00:00,3,2,23.76,78.51,13.19,2,192,194
2011-07-03 21:00:00,2,4,16.76,41.81,36.05,10,187,197
2011-07-03 22:00:00,4,4,34.69,65.75,23.79,45,47,92
2011-07-03 23:00:00,1,2,19.36,39.38,37.9,27,71,98
2011-07-04 00:00:00,3,1,11.85,87.11,24.33,41,146,187
2011-07-04 01:00:00,2,3,16.46,58.44,27.78,30,104,134
2011-07-04 02:00:00,3,2,24.62,71.44,5.55,8,34,42
2011-07-04 03:00:00,3,3,7.28,83.53,38.83,26,96,122
2011-07-04 04:00:00,2,1,23.11,91.63,37.91,11,108,119
2011-07-04 05:00:00,3,4,32.94,78.56,15.38,7,108,115
2011-07-04 06:00:00,1,3,30.51,31.9,16.43,43,32,75
2011-07-04 07:00:00,4,1,7.03,88.36,10.98,40,169,209
2011-07-04 08:00:00,4,1,34.8,69.49,40.69,21,114,135
2011-07-04 09:00:00,1,4,25.96,68.76,37.35,17,53,70
2011-07-04 10:00:00,3,4,9.87,93.71,30.46,29,38,67
2011-07-04 11:00:00,2,1,5.37,39.91,11.94,48,109,157
2011-07-04 12:00:00,3,1,10.14,39.17,8.59,10,191,201
2011-07-04 13:00:00,1,3,30.15,61.06,2.51,1,165,166
2011-07-04 14:00:00,3,1,5.65,80.07,2.28,28,37,65
2011-07-04 15:00:00,4,1,11.99,55.78,9.36,25,72,97
2011-07-04 16:00:00,3,3,27.72,70.71,5.03,13,179,192
2011-07-04 17:00:00,1,2,22.58,56.2,27.81,27,111,138
2011-07-04 18:00:00,4,3,28.48,68.83,17.9,34,100,134
2011-07-04 19:00:00,3,3,27.38,85.78,22.25,5,46,51
2011-07-04 20:00:00,3,4,6.52,34.44,29.7,35,125,160
2011-07-04 21:00:00,4,3,31.78,75.63,32.96,11,64,75
2011-07-04 22:00:00,2,1,11.81,82.99,32.41,33,99,132
2011-07-04 23:00:00,4,1,21.6,55.77,13.04,5,41,46
2011-07-05 00:00:00,2,1,24.33,45.86,40.48,36,101,137
2011-07-05 01:00:00,1,2,10.06,21.08,45.89,36,54,90
2011-07-05 02:00:00,1,1,34.29,83.77,15.8,7,58,65
2011-07-05 03:00:00,4,2,19.64,46.24,0.85,36,193,229
2011-07-05 04:00:00,4,1,6.73,48.58,44.96,39,73,112
2011-07-05 05:00:00,1,3,33.12,46.88,46.18,32,181,213
2011-07-05 06:00:00,2,4,22.59,59.9,2.55,40,50,90
2011-07-05 07:00:00,1,1,25.98,76.2,0.25,45,150,195
2011-07-05 08:00:00,4,2,20.76,81.75,40.82,30,138,168
2011-07-05 09:00:00,1,2,30.04,51.41,15.07,33,35,68
2011-07-05 10:00:00,4,4,5.99,73.05,45.73,10,183,193
2011-07-05 11:00:00,4,1,13.05,77.65,10.84,35,41,76
2011-07-05 12:00:00,1,3,19.09,43.75,43.06,3,101,104
2011-07-05 13:00:00,2,1,7.3,27.73,3.43,16,98,114
2011-07-05 14:00:00,3,1,26.18,91.57,13.03,15,127,142
2011-07-05 15:00:00,1,4,16.81,74.17,48.66,29,12,41
2011-07-05 16:00:00,3,1,13.18,71.85,11.56,38,98,136
2011-07-05 17:00:00,1,3,5.1,24.71,6.65,43,51,94
2011-07-05 18:00:00,3,2,26.59,85.43,42.85,48,157,205
2011-07-05 19:00:00,2,4,30.01,65.28,5.89,4,139,143
2011-07-05 20:00:00,2,3,16.85,87.83,4.87,39,148,187
2011-07-05 21:00:00,1,2,21.93,97.96,16.17,36,139,175
2011-07-05 22:00:00,4,4,11.83,96.57,31.77,42,61,103
2011-07-05 23:00:00,3,4,23.67,88.49,35.54,25,119,144
2011-07-06 00:00:00,4,2,5.36,20.88,44.06,27,92,119
2011-07-06 01:00:00,4,2,19.66,90.86,27.05,18,166,184
2011-07-06 02:00:00,4,3,24.33,26.0,19.67,20,43,63
2011-07-06 03:00:00,2,1,32.55,88.1,17.94,27,131,158
2011-07-06 04:00:00,1,1,16.44,42.41,42.35,18,158,176
2011-07-06 05:00:00,1,1,27.96,68.81,36.19,35,151,186
2011-07-06 06:00:00,2,1,22.93,23.05,45.27,10,169,179
2011-07-06 07:00:00,2,1,32.81,81.69,48.2,18,122,140
2011-07-06 08:00:00,1,3,16.95,28.94,15.0,4,176,180
2011-07-06 09:00:00,4,4,14.57,52.86,26.48,1,89,90
2011-07-06 10:00:00,3,3,31.61,85.4,31.59,24,147,171
2011-07-06 11:00:00,3,3,6.48,75.63,8.19,25,135,160
2011-07-06 12:00:00,3,3,9.09,20.48,2.67,29,160,189
2011-07-06 13:00:00,4,4,7.47,52.24,43.39,16,195,211
2011-07-06 14:00:00,1,3,30.29,23.35,26.78,20,165,185
2011-07-06 15:00:00,2,3,5.32,73.88,28.54,19,163,182
2011-07-06 16:00:00,1,4,30.85,97.52,27.75,17,47,64
2011-07-06 17:00:00,4,3,18.54,72.42,37.75,46,135,181
2011-07-06 18:00:00,2,1,5.12,37.95,7.28,15,59,74
2011-07-06 19:00:00,4,2,17.05,48.42,30.7,27,23,50
2011-07-06 20:00:00,3,3,10.6,98.13,23.47,11,16,27
2011-07-06 21:00:00,3,2,23.73,37.92,44.85,39,64,103
2011-07-06 22:00:00,4,3,25.38,64.92,25.98,5,166,171
2011-07-06 23:00:00,2,3,19.63,52.04,47.15,23,105,128
2011-07-07 00:00:00,2,1,6.22,81.47,17.66,49,54,103
2011-07-07 01:00:00,1,4,24.68,89.39,48.34,42,76,118
2011-07-07 02:00:00,3,2,30.26,47.27,43.76,5,60,65
2011-07-07 03:00:00,1,4,26.61,72.83,29.21,16,30,46
2011-07-07 04:00:00,1,1,29.9,63.92,17.69,41,100,141
2011-07-07 05:00:00,4,1,11.02,42.28,18.8,18,27,45
2011-07-07 06:00:00,4,2,31.67,41.76,38.64,46,31,77
2011-07-07 07:00:00,1,4,14.67,63.09,29.03,47,6,53
2011-07-07 08:00:00,3,1,5.4,32.32,20.08,27,13,40
2011-07-07 09:00:00,4,3,30.3,84.86,31.8,28,72,100
2011-07-07 10:00:00,1,3,33.25,25.52,36.66,48,181,229
2011-07-07 11:00:00,1,3,24.67,27.57,1.15,6,69,75
2011-07-07 12:00:00,1,4,11.94,47.38,4.49,18,178,196
2011-07-07 13:00:00,1,3,12.55,29.45,4.72,7,29,36
2011-07-07 14:00:00,1,3,19.0,58.06,11.6,7,157,164
2011-07-07 15:00:00,1,1,31.93,51.97,21.35,4,143,147
2011-07-07 16:00:00,4,1,9.49,77.74,40.18,42,150,192
2011-07-07 17:00:00,3,3,29.78,96.24,17.55,33,158,191
2011-07-07 18:00:00,1,3,13.74,80.28,0.87,49,11,60
2011-07-07 19:00:00,2,1,29.26,34.36,24.17,20,2,22
2011-07-07 20:00:00,4,2,32.61,94.84,49.83,3,66,69
2011-07-07 21:00:00,4,4,17.82,51.37,17.45,43,165,208
2011-07-07 22:00:00,1,4,15.95,57.94,48.06,35,85,120
2011-07-07 23:00:00,4,1,29.07,53.73,5.07,4,114,118
2011-07-08 00:00:00,1,4,20.88,42.44,8.65,48,107,155
2011-07-08 01:00:00,3,1,25.53,91.6,36.21,22,143,165
2011-07-08 02:00:00,3,1,23.68,46.58,25.06,18,81,99
2011-07-08 03:00:00,4,1,9.59,66.29,38.26,41,3,44
2011-07-08 04:00:00,4,1,30.34,39.2,43.18,45,19,64
2011-07-08 05:00:00,2,2,10.87,83.79,12.55,14,44,58
2011-07-08 06:00:00,4,3,32.97,81.94,34.14,13,140,153
2011-07-08 07:00:00,2,3,12.52,43.7,30.38,47,94,141
2011-07-08 08:00:00,3,2,27.02,74.52,43.08,7,129,136
2011-07-08 09:00:00,3,4,13.54,76.31,21.51,8,93,101
2011-07-08 10:00:00,1,4,14.53,65.0,2.59,39,30,69
2011-07-08 11:00:00,3,3,14.3,68.05,28.71,10,27,37
2011-07-08 12:00:00,2,4,27.44,65.96,47.94,43,72,115
2011-07-08 13:00:00,4,3,21.7,26.55,0.73,45,58,103
2011-07-08 14:00:00,1,3,31.49,73.62,12.01,17,138,155
2011-07-08 15:00:00,2,2,14.22,57.58,15.8,31,162,193
2011-07-08 16:00:00,4,4,25.76,55.08,38.29,43,48,91
2011-07-08 17:00:00,1,2,27.59,88.8,16.16,35,171,206
2011-07-08 18:00:00,3,3,9.54,21.86,11.95,44,185,229
2011-07-08 19:00:00,2,3,17.02,40.11,32.43,20,178,198
2011-07-08 20:00:00,4,3,19.48,29.71,2.32,26,117,143
2011-07-08 21:00:00,1,1,15.67,22.83,8.53,47,16,63
2011-07-08 22:00:00,1,1,14.66,42.05,20.4,41,125,166
2011-07-08 23:00:00,3,1,25.59,99.08,17.78,20,131,151
2011-07-09 00:00:00,4,2,11.48,41.62,17.36,10,160,170
2011-07-09 01:00:00,3,3,26.28,73.1,5.43,43,189,232
2011-07-09 02:00:00,3,4,33.05,29.46,18.04,49,80,129
2011-07-09 03:00:00,4,2,21.96,68.15,39.9,33,105,138
2011-07-09 04:00:00,4,2,23.34,98.76,20.69,4,199,203
2011-07-09 05:00:00,4,2,7.07,43.35,29.31,27,89,116
2011-07-09 06:00:00,2,4,30.93,87.85,8.18,9,170,179
2011-07-09 07:00:00,4,3,13.56,99.81,3.49,47,83,130
2011-07-09 08:00:00,1,1,23.45,67.08,44.0,11,41,52
2011-07-09 09:00:00,3,3,34.37,44.75,16.57,40,178,218
2011-07-09 10:00:00,2,3,22.87,73.88,17.52,2,165,167
2011-07-09 11:00:00,4,2,26.74,87.59,43.88,0,170,170
2011-07-09 12:00:00,2,2,18.36,33.71,35.39,36,47,83
2011-07-09 13:00:00,4,2,6.81,56.2,37.81,39,41,80
2011-07-09 14:00:00,2,1,28.93,45.54,34.1,48,184,232
2011-07-09 15:00:00,3,1,6.05,42.67,5.29,0,53,53
2011-07-09 16:00:00,3,1,26.02,88.87,47.9,12,96,108
2011-07-09 17:00:00,1,3,5.69,53.73,45.46,37,144,181
2011-07-09 18:00:00,1,2,30.87,47.13,11.81,14,178,192
2011-07-09 19:00:00,4,4,9.73,68.28,40.2,6,136,142
2011-07-09 20:00:00,3,3,20.43,37.55,20.47,29,7,36
2011-07-09 21:00:00,2,1,22.91,38.39,34.19,23,190,213
2011-07-09 22:00:00,2,4,18.73,61.62,8.28,7,111,118
2011-07-09 23:00:00,2,4,15.22,52.74,26.93,2,109,111
2011-07-10 00:00:00,1,2,19.03,43.6,6.33,14,183,197
2011-07-10 01:00:00,2,4,14.34,24.32,26.81,35,69,104
2011-07-10 02:00:00,1,1,18.14,61.66,12.18,40,136,176
2011-07-10 03:00:00,1,2,15.77,85.33,22.62,42,110,152
2011-07-10 04:00:00,4,4,21.99,88.11,33.4,13,110,123
2011-07-10 05:00:00,2,2,12.14,38.84,43.85,26,4,30
2011-07-10 06:00:00,2,4,34.66,67.97,8.26,29,71,100
2011-07-10 07:00:00,3,3,20.03,88.47,44.66,40,63,103
2011-07-10 08:00:00,4,3,10.82,52.7,19.5,43,179,222
2011-07-10 09:00:00,3,1,19.31,94.57,42.19,36,34,70
2011-07-10 10:00:00,4,3,30.99,92.24,25.63,5,59,64
2011-07-10 11:00:00,2,3,5.65,36.65,43.11,18,88,106
2011-07-10 12:00:00,1,3,25.39,40.72,33.14,36,99,135
2011-07-10 13:00:00,1,4,21.44,34.44,25.44,0,38,38
2011-07-10 14:00:00,1,4,10.09,35.68,15.63,24,112,136
2011-07-10 15:00:00,1,2,29.52,92.63,48.45,9,133,142
2011-07-10 16:00:00,1,4,16.07,94.49,40.04,45,87,132
2011-07-10 17:00:00,3,3,13.81,24.15,19.06,25,118,143
2011-07-10 18:00:00,4,4,29.84,67.49,8.34,22,148,170
2011-07-10 19:00:00,2,1,24.16,65.14,38.98,16,163,179
2011-07-10 20:00:00,3,2,31.95,51.24,49.5,29,17,46
2011-07-10 21:00:00,4,2,23.9,70.54,13.95,26,111,137
2011-07-10 22:00:00,1,4,27.22,95.79,45.79,10,0,10
2011-07-10 23:00:00,4,3,30.09,33.62,6.27,3,16,19
2011-07-11 00:00:00,4,2,6.64,29.63,47.61,17,196,213
2011-07-11 01:00:00,1,1,28.28,22.67,37.27,18,120,138
2011-07-11 02:00:00,1,1,23.41,49.11,17.33,35,113,148
2011-07-11 03:00:00,1,2,7.09,47.01,15.23,43,133,176
2011-07-11 04:00:00,2,3,20.26,54.47,32.17,45,57,102
2011-07-11 05:00:00,1,3,7.47,60.26,29.68,49,172,221
2011-07-11 06:00:00,2,4,27.08,80.63,45.95,25,71,96
2011-07-11 07:00:00,1,4,21.4,51.37,38.31,0,122,122
2011-07-11 08:00:00,2,2,33.61,46.45,27.02,19,123,142
2011-07-11 09:00:00,4,4,10.49,86.15,46.38,10,47,57
2011-07-11 10:00:00,3,4,23.18,87.98,29.64,24,177,201
2011-07-11 11:00:00,4,4,11.35,38.62,42.48,18,55,73
2011-07-11 12:00:00,4,1,23.42,45.17,42.05,31,136,167
2011-07-11 13:00:00,1,4,26.68,86.01,45.96,0,189,189
2011-07-11 14:00:00,2,2,26.67,26.35,3.38,0,120,120
2011-07-11 15:00:00,3,3,29.45,46.07,29.19,2,30,32
2011-07-11 16:00:00,1,4,30.61,55.87,23.42,45,64,109
2011-07-11 17:00:00,1,3,7.32,34.97,24.53,39,104,143
2011-07-11 18:00:00,1,4,15.3,34.39,23.0,31,60,91
2011-07-11 19:00:00,4,2,25.61,53.99,41.87,46,137,183
2011-07-11 20:00:00,2,1,19.96,80.36,15.92,35,180,215
2011-07-11 21:00:00,2,2,10.72,87.22,23.14,42,125,167
2011-07-11 22:00:00,3,1,21.58,98.34,10.03,7,191,198
2011-07-11 23:00:00,2,4,17.22,25.92,12.59,29,191,220
2011-07-12 00:00:00,2,4,16.7,37.33,33.02,38,177,215
2011-07-12 01:00:00,1,1,29.29,80.53,5.85,33,192,225
2011-07-12 02:00:00,1,2,17.23,63.25,9.39,7,76,83
2011-07-12 03:00:00,4,2,5.79,46.21,26.4,24,141,165
2011-07-12 04:00:00,1,1,6.74,36.45,2.19,25,22,47
2011-07-12 05:00:00,1,4,30.69,42.44,6.35,26,126,152
2011-07-12 06:00:00,1,1,33.82,54.34,43.17,18,155,173
2011-07-12 07:00:00,1,4,25.65,34.17,42.31,22,92,114
2011-07-12 08:00:00,4,1,15.93,97.14,17.39,40,57,97
2011-07-12 09:00:00,1,4,33.16,28.61,17.4,15,167,182
2011-07-12 10:00:00,3,1,24.88,98.85,46.83,7,191,198
2011-07-12 11:00:00,3,3,30.33,87.35,1.29,29,96,125
2011-07-12 12:00:00,3,4,27.98,53.85,29.01,7,129,136
2011-07-12 13:00:00,3,2,16.37,79.19,29.87,10,170,180
2011-07-12 14:00:00,1,1,19.36,73.72,39.39,6,11,17
2011-07-12 15:00:00,3,2,10.58,37.06,47.59,20,103,123
2011-07-12 16:00:00,1,1,13.76,47.13,17.79,33,91,124
2011-07-12 17:00:00,4,2,28.34,61.05,21.89,20,34,54
2011-07-12 18:00:00,3,2,31.82,71.03,33.56,4,73,77
2011-07-12 19:00:00,2,1,26.73,63.43,48.36,49,110,159
2011-07-12 20:00:00,3,1,18.96,57.84,44.54,42,107,149
2011-07-12 21:00:00,3,2,7.6,55.45,33.35,16,120,136
2011-07-12 22:00:00,1,2,6.71,59.86,42.84,20,196,216
2011-07-12 23:00:00,3,2,16.23,54.75,4.26,5,190,195
2011-07-13 00:00:00,2,4,18.91,63.31,18.86,44,168,212
2011-07-13 01:00:00,1,4,23.27,91.04,0.65,6,63,69
2011-07-13 02:00:00,1,3,5.19,70.63,8.87,10,17,27
2011-07-13 03:00:00,4,4,34.69,77.81,31.52,17,197,214
2011-07-13 04:00:00,4,4,15.92,67.8,44.28,37,138,175
2011-07-13 05:00:00,3,1,30.44,71.44,31.64,11,64,75
2011-07-13 06:00:00,4,3,21.05,66.27,33.21,21,150,171
2011-07-13 07:00:00,4,3,8.91,22.15,5.19,2,3,5
2011-07-13 08:00:00,4,4,28.93,99.97,33.24,18,6,24
2011-07-13 09:00:00,1,1,26.29,22.69,22.72,42,168,210
2011-07-13 10:00:00,1,1,20.82,51.61,32.57,22,176,198
2011-07-13 11:00:00,1,3,20.44,28.41,16.31,33,144,177
2011-07-13 12:00:00,4,1,7.62,27.75,29.07,2,74,76
2011-07-13 13:00:00,1,2,24.68,83.48,21.2,22,54,76
2011-07-13 14:00:00,4,4,32.34,54.07,27.93,48,121,169
2011-07-13 15:00:00,1,2,7.8,84.09,7.35,4,26,30
2011-07-13 16:00:00,1,3,12.91,41.82,19.79,28,139,167
2011-07-13 17:00:00,2,3,32.07,40.52,18.71,33,174,207
2011-07-13 18:00:00,3,1,13.53,40.1,36.82,43,161,204
2011-07-13 19:00:00,4,1,24.62,69.29,35.32,4,135,139
2011-07-13 20:00:00,2,3,21.04,85.2,45.44,28,115,143
2011-07-13 21:00:00,1,3,22.89,56.18,31.6,44,22,66
2011-07-13 22:00:00,4,2,17.47,50.34,15.73,23,25,48
2011-07-13 23:00:00,1,2,14.0,97.89,39.16,38,161,199
2011-07-14 00:00:00,3,1,6.46,29.34,24.85,20,159,179
2011-07-14 01:00:00,2,2,27.33,58.93,9.67,31,5,36
2011-07-14 02:00:00,3,1,27.38,52.68,37.37,42,192,234
2011-07-14 03:00:00,2,1,25.12,27.85,6.63,4,120,124
2011-07-14 04:00:00,1,4,24.31,41.46,8.91,17,58,75
2011-07-14 05:00:00,3,1,12.31,22.28,37.94,37,177,214
2011-07-14 06:00:00,3,2,5.67,90.16,38.51,34,195,229
2011-07-14 07:00:00,1,3,29.26,68.63,39.54,37,7,44
2011-07-14 08:00:00,3,3,19.73,85.2,14.67,15,39,54
2011-07-14 09:00:00,4,2,14.21,61.72,43.33,34,173,207
2011-07-14 10:00:00,2,3,8.06,67.96,36.13,49,83,132
2011-07-14 11:00:00,2,1,6.88,76.07,41.7,23,160,183
2011-07-14 12:00:00,2,3,15.47,92.64,35.43,35,57,92
2011-07-14 13:00:00,4,2,29.14,27.34,28.98,4,115,119
2011-07-14 14:00:00,2,3,32.56,46.48,5.47,8,130,138
2011-07-14 15:00:00,1,1,31.9,76.72,35.55,3,78,81
2011-07-14 16:00:00,3,1,32.6,96.67,34.52,32,154,186
2011-07-14 17:00:00,4,2,32.23,98.46,15.62,26,64,90
2011-07-14 18:00:00,2,2,20.82,71.05,36.79,21,56,77
2011-07-14 19:00:00,1,2,11.58,35.49,27.52,10,162,172
2011-07-14 20:00:00,3,4,28.94,29.54,27.97,4,179,183
2011-07-14 21:00:00,3,4,11.41,95.68,18.38,9,178,187
2011-07-14 22:00:00,4,1,13.02,54.71,5.84,2,16,18
2011-07-14 23:00:00,4,4,12.0,35.59,10.85,14,51,65
2011-07-15 00:00:00,4,4,20.45,94.71,38.44,45,175,220
2011-07-15 01:00:00,1,3,14.65,28.36,13.57,36,57,93
2011-07-15 02:00:00,1,4,9.62,78.37,0.11,39,75,114
2011-07-15 03:00:00,4,3,18.6,70.02,49.85,16,102,118
2011-07-15 04:00:00,2,2,31.22,27.02,10.53,19,25,44
2011-07-15 05:00:00,3,3,22.12,47.1,32.77,3,26,29
2011-07-15 06:00:00,3,3,31.35,31.99,46.35,33,23,56
2011-07-15 07:00:00,1,2,10.88,68.36,29.99,33,80,113
2011-07-15 08:00:00,3,2,10.01,58.17,39.95,30,138,168
2011-07-15 09:00:00,2,1,22.27,20.34,48.82,33,85,118
2011-07-15 10:00:00,3,1,18.9,98.06,43.02,2,135,137
2011-07-15 11:00:00,1,1,24.81,47.97,27.9,27,175,202
2011-07-15 12:00:00,1,1,28.84,40.66,18.19,40,31,71
2011-07-15 13:00:00,2,3,27.54,37.8,24.12,36,28,64
2011-07-15 14:00:00,2,3,33.27,32.71,42.09,28,105,133
2011-07-15 15:00:00,3,1,16.95,99.93,42.67,14,95,109
2011-07-15 16:00:00,3,4,11.19,43.61,42.29,35,120,155
2011-07-15 17:00:00,1,1,21.53,52.44,29.86,34,103,137
2011-07-15 18:00:00,2,4,8.32,89.71,23.85,40,132,172
2011-07-15 19:00:00,2,2,13.67,71.35,15.57,9,176,185
2011-07-15 20:00:00,2,3,11.24,49.5,0.17,16,140,156
2011-07-15 21:00:00,3,3,16.9,91.87,38.22,29,127,156
2011-07-15 22:00:00,2,4,8.34,79.98,13.85,7,88,95
2011-07-15 23:00:00,1,1,5.96,38.23,16.48,22,41,63
2011-07-16 00:00:00,1,3,24.7,71.5,42.17,18,9,27
2011-07-16 01:00:00,3,4,23.31,93.79,2.61,36,153,189
2011-07-16 02:00:00,4,2,26.25,59.72,46.38,42,25,67
2011-07-16 03:00:00,3,2,24.81,78.69,0.07,35,150,185
2011-07-16 04:00:00,4,3,8.43,97.69,46.96,3,171,174
2011-07-16 05:00:00,2,1,13.73,75.23,22.74,25,75,100
2011-07-16 06:00:00,3,4,8.89,28.2,5.11,46,38,84
2011-07-16 07:00:00,1,3,30.29,39.56,33.71,39,170,209
2011-07-16 08:00:00,2,2,27.41,67.61,44.79,26,51,77
2011-07-16 09:00:00,1,1,11.05,42.04,21.9,12,122,134
2011-07-16 10:00:00,2,4,15.24,96.6,34.57,43,57,100
2011-07-16 11:00:00,3,3,34.0,52.43,48.97,33,75,108
2011-07-16 12:00:00,4,4,22.82,56.58,12.04,32,99,131
2011-07-16 13:00:00,2,1,29.03,76.13,41.02,45,159,204
2011-07-16 14:00:00,4,1,12.94,61.94,14.76,25,17,42
2011-07-16 15:00:00,2,2,11.3,50.57,21.32,19,41,60
2011-07-16 16:00:00,1,1,28.52,26.13,14.09,7,1,8
2011-07-16 17:00:00,1,3,25.58,67.72,22.3,15,187,202
2011-07-16 18:00:00,2,4,25.43,89.41,0.25,4,32,36
2011-07-16 19:00:00,4,1,21.58,74.86,15.17,33,173,206
2011-07-16 20:00:00,3,1,21.91,50.52,22.26,46,58,104
2011-07-16 21:00:00,3,3,27.07,30.22,31.61,26,99,125
2011-07-16 22:00:00,1,4,13.1,85.31,31.87,35,184,219
2011-07-16 23:00:00,3,4,15.58,95.34,29.19,3,189,192
2011-07-17 00:00:00,1,2,31.15,51.06,14.65,41,190,231
2011-07-17 01:00:00,3,2,14.27,78.29,47.37,49,72,121
2011-07-17 02:00:00,2,4,21.39,52.86,19.6,6,158,164
2011-07-17 03:00:00,1,3,26.08,60.18,10.84,36,166,202
2011-07-17 04:00:00,1,3,35.0,86.92,27.73,35,84,119
2011-07-17 05:00:00,2,2,18.06,26.67,37.45,23,21,44
2011-07-17 06:00:00,1,1,17.84,62.43,0.61,14,16,30
2011-07-17 07:00:00,3,3,30.28,37.17,13.82,49,130,179
2011-07-17 08:00:00,3,1,29.17,47.18,41.25,48,31,79
2011-07-17 09:00:00,1,3,26.93,71.55,25.35,5,32,37
2011-07-17 10:00:00,3,4,18.9,22.18,20.42,25,191,216
2011-07-17 11:00:00,4,2,14.72,67.51,46.55,25,9,34
2011-07-17 12:00:00,1,1,23.26,42.68,4.48,24,4,28
2011-07-17 13:00:00,2,1,31.29,73.56,30.78,32,67,99
2011-07-17 14:00:00,4,4,31.51,31.33,17.11,2,165,167
2011-07-17 15:00:00,1,3,8.25,78.86,3.54,8,101,109
2011-07-17 16:00:00,2,1,17.85,71.65,10.69,36,168,204
2011-07-17 17:00:00,3,3,18.94,97.7,31.4,37,72,109
2011-07-17 18:00:00,2,4,34.33,92.9,1.41,29,188,217
2011-07-17 19:00:00,4,2,25.34,42.66,29.61,26,142,168
2011-07-17 20:00:00,3,1,17.22,22.19,47.84,12,51,63
2011-07-17 21:00:00,1,3,5.78,72.43,39.75,22,7,29
2011-07-17 22:00:00,3,1,21.96,68.23,17.28,2,183,185
2011-07-17 23:00:00,1,3,7.88,22.19,6.91,22,97,119
2011-07-18 00:00:00,1,3,30.03,29.81,23.25,34,29,63
2011-07-18 01:00:00,2,3,27.58,66.78,19.65,23,73,96
2011-07-18 02:00:00,2,4,18.82,92.95,48.59,36,77,113
2011-07-18 03:00:00,2,2,17.88,92.52,49.49,11,123,134
2011-07-18 04:00:00,4,1,31.92,32.12,20.53,19,161,180
2011-07-18 05:00:00,4,2,13.65,50.77,7.44,17,186,203
2011-07-18 06:00:00,2,3,12.47,23.46,45.53,6,183,189
2011-07-18 07:00:00,4,3,33.18,57.54,39.68,25,140,165
2011-07-18 08:00:00,3,2,29.28,80.25,25.56,11,178,189
2011-07-18 09:00:00,3,2,29.62,83.2,18.27,33,58,91
2011-07-18 10:00:00,4,1,10.86,59.92,22.41,47,61,108
2011-07-18 11:00:00,4,3,9.3,27.67,45.09,31,28,59
2011-07-18 12:00:00,3,2,5.78,50.51,9.23,29,92,121
2011-07-18 13:00:00,1,4,12.11,94.57,40.34,1,61,62
2011-07-18 14:00:00,3,3,28.23,38.37,0.91,7,134,141
2011-07-18 15:00:00,3,3,12.2,45.58,46.03,32,171,203
2011-07-18 16:00:00,4,1,26.87,79.75,25.01,45,133,178
2011-07-18 17:00:00,3,4,12.56,78.69,11.34,41,61,102
2011-07-18 18:00:00,4,1,16.86,92.98,0.14,29,67,96
2011-07-18 19:00:00,4,4,34.49,51.05,27.98,44,197,241
2011-07-18 20:00:00,2,1,12.34,61.17,12.22,41,16,57
2011-07-18 21:00:00,3,4,16.29,57.39,31.56,44,176,220
2011-07-18 22:00:00,1,4,14.03,94.22,14.06,27,151,178
2011-07-18 23:00:00,2,4,8.29,81.55,4.4,12,139,151
2011-07-19 00:00:00,4,2,19.7,86.52,25.25,23,56,79
2011-07-19 01:00:00,4,3,16.36,30.65,28.22,32,156,188
2011-07-19 02:00:00,1,4,25.85,83.35,22.63,4,87,91
2011-07-19 03:00:00,4,2,29.53,54.64,22.9,47,61,108
2011-07-19 04:00:00,3,2,21.33,21.87,29.48,5,97,102
2011-07-19 05:00:00,2,1,5.97,24.81,26.32,3,77,80
2011-07-19 06:00:00,4,3,23.57,74.23,6.63,41,26,67
2011-07-19 07:00:00,4,3,6.66,49.76,9.85,42,132,174
2011-07-19 08:00:00,1,1,23.49,89.45,7.09,33,39,72
2011-07-19 09:00:00,3,3,25.55,78.74,34.66,28,174,202
2011-07-19 10:00:00,4,1,10.93,21.73,26.43,20,136,156
2011-07-19 11:00:00,1,2,29.58,74.95,21.49,25,143,168
2011-07-19 12:00:00,4,2,32.33,35.39,39.92,31,12,43
2011-07-19 13:00:00,1,4,29.39,53.81,16.29,21,181,202
2011-07-19 14:00:00,1,1,14.15,69.98,28.41,40,142,182
2011-07-19 15:00:00,3,2,22.6,89.82,3.72,13,152,165
2011-07-19 16:00:00,4,2,32.44,56.49,37.22,33,143,176
2011-07-19 17:00:00,3,1,14.62,84.68,34.76,36,43,79
2011-07-19 18:00:00,1,2,29.6,82.64,40.12,43,115,158
2011-07-19 19:00:00,2,3,5.28,53.16,44.22,0,117,117
2011-07-19 20:00:00,4,2,5.11,60.08,37.9,31,94,125
2011-07-19 21:00:00,2,1,27.79,76.04,42.22,31,46,77
2011-07-19 22:00:00,4,3,27.84,22.49,17.28,23,160,183
2011-07-19 23:00:00,3,3,28.67,91.26,17.17,43,83,126
2011-07-20 00:00:00,3,2,32.9,81.59,47.22,20,153,173
2011-07-20 01:00:00,3,4,8.54,39.95,45.73,11,39,50
2011-07-20 02:00:00,3,3,11.96,98.49,27.42,19,70,89
2011-07-20 03:00:00,3,1,32.11,34.35,18.33,36,172,208
2011-07-20 04:00:00,2,4,10.32,93.13,43.3,19,105,124
2011-07-20 05:00:00,3,4,25.47,45.96,16.17,1,94,95
2011-07-20 06:00:00,1,3,20.91,81.05,7.68,13,170,183
2011-07-20 07:00:00,1,2,7.5,56.51,31.97,16,199,215
2011-07-20 08:00:00,2,4,13.56,78.92,2.13,23,22,45
2011-07-20 09:00:00,4,2,20.61,32.46,18.96,29,46,75
2011-07-20 10:00:00,1,3,30.57,41.56,40.38,14,43,57
2011-07-20 11:00:00,4,1,26.23,27.99,14.76,48,81,129
2011-07-20 12:00:00,2,4,23.66,89.21,46.57,33,169,202
2011-07-20 13:00:00,4,1,19.88,43.7,47.79,7,11,18
2011-07-20 14:00:00,4,2,13.96,75.56,40.79,41,93,134
2011-07-20 15:00:00,4,2,8.58,85.62,49.38,2,163,165
2011-07-20 16:00:00,4,1,17.27,92.11,26.54,10,78,88
2011-07-20 17:00:00,2,3,5.86,28.5,28.46,26,140,166
2011-07-20 18:00:00,1,3,11.33,91.44,41.81,8,80,88
2011-07-20 19:00:00,3,4,17.97,35.78,24.64,14,192,206
2011-07-20 20:00:00,4,4,17.56,78.95,20.34,31,119,150
2011-07-20 21:00:00,1,3,6.33,78.31,30.74,10,100,110
2011-07-20 22:00:00,1,3,22.67,20.68,32.88,2,112,114
2011-07-20 23:00:00,2,1,21.49,37.65,37.54,25,26,51
2011-07-21 00:00:00,1,2,7.34,59.35,33.41,6,147,153
2011-07-21 01:00:00,2,2,33.29,53.6,37.29,27,17,44
2011-07-21 02:00:00,4,4,7.98,93.49,33.73,38,63,101
2011-07-21 03:00:00,4,3,30.65,48.78,24.02,3,8,11
2011-07-21 04:00:00,3,1,5.01,94.96,6.75,29,117,146
2011-07-21 05:00:00,3,4,31.47,56.75,39.27,37,122,159
2011-07-21 06:00:00,3,1,5.59,97.15,1.54,13,24,37
2011-07-21 07:00:00,1,3,27.73,78.99,49.63,35,112,147
2011-07-21 08:00:00,4,3,15.85,86.35,41.42,30,128,158
2011-07-21 09:00:00,2,3,27.15,28.39,33.55,18,58,76
2011-07-21 10:00:00,3,2,17.05,66.89,48.33,48,163,211
2011-07-21 11:00:00,2,3,7.13,31.42,30.62,11,17,28
2011-07-21 12:00:00,2,4,28.03,43.81,2.82,48,46,94
2011-07-21 13:00:00,3,2,7.14,69.89,27.97,14,78,92
2011-07-21 14:00:00,4,1,32.66,78.1,13.86,8,160,168
2011-07-21 15:00:00,3,4,6.53,23.13,18.47,26,21,47
2011-07-21 16:00:00,2,4,19.38,62.48,22.98,19,87,106
2011-07-21 17:00:00,3,1,26.69,65.23,38.73,27,64,91
2011-07-21 18:00:00,2,2,16.8,26.31,25.15,24,138,162
2011-07-21 19:00:00,2,4,11.52,60.06,23.73,15,106,121
2011-07-21 20:00:00,3,4,27.77,77.11,15.1,17,153,170
2011-07-21 21:00:00,1,4,28.53,24.26,26.99,49,89,138
2011-07-21 22:00:00,3,2,32.68,80.82,12.42,35,197,232
2011-07-21 23:00:00,1,2,16.28,66.11,13.05,3,190,193
2011-07-22 00:00:00,2,2,20.19,86.66,37.86,20,37,57
2011-07-22 01:00:00,2,4,15.89,37.45,17.13,26,125,151
2011-07-22 02:00:00,1,3,12.71,86.66,2.57,0,48,48
2011-07-22 03:00:00,2,1,27.53,27.56,17.18,4,104,108
2011-07-22 04:00:00,1,3,15.19,52.31,31.93,43,144,187
2011-07-22 05:00:00,1,2,17.84,35.96,40.7,45,56,101
2011-07-22 06:00:00,2,4,17.11,90.08,48.1,9,13,22
2011-07-22 07:00:00,4,4,26.38,76.39,37.31,49,82,131
2011-07-22 08:00:00,1,3,32.53,22.03,21.44,20,7,27
2011-07-22 09:00:00,3,3,25.0,20.76,14.96,9,183,192
2011-07-22 10:00:00,3,1,19.15,43.3,6.48,25,22,47
2011-07-22 11:00:00,2,4,28.38,31.46,31.38,15,43,58
2011-07-22 12:00:00,4,3,24.23,70.42,25.49,37,65,102
2011-07-22 13:00:00,2,1,6.82,73.1,33.89,2,2,4
2011-07-22 14:00:00,4,2,7.87,95.36,11.86,19,180,199
2011-07-22 15:00:00,1,3,6.14,96.16,16.18,46,140,186
2011-07-22 16:00:00,1,2,18.7,72.71,14.6,4,68,72
2011-07-22 17:00:00,1,1,29.78,20.45,39.88,5,81,86
2011-07-22 18:00:00,1,2,14.39,48.72,8.56,24,0,24
2011-07-22 19:00:00,3,4,16.52,61.05,30.42,24,20,44
2011-07-22 20:00:00,3,4,32.28,59.93,2.57,11,82,93
2011-07-22 21:00:00,2,2,30.11,68.27,27.48,0,55,55
2011-07-22 22:00:00,4,4,24.95,96.84,3.2,41,101,142
2011-07-22 23:00:00,1,1,13.0,90.82,8.79,2,129,131
2011-07-23 00:00:00,1,4,8.51,28.71,5.65,20,30,50
2011-07-23 01:00:00,4,2,5.48,41.28,17.34,4,140,144
2011-07-23 02:00:00,4,2,8.21,86.65,17.19,14,13,27
2011-07-23 03:00:00,2,2,13.78,85.94,41.32,3,75,78
2011-07-23 04:00:00,4,3,21.55,42.03,11.28,18,184,202
2011-07-23 05:00:00,1,2,6.92,78.45,4.32,16,12,28
2011-07-23 06:00:00,1,1,9.09,73.76,30.18,7,87,94
2011-07-23 07:00:00,1,4,10.43,57.88,34.37,36,94,130
2011-07-23 08:00:00,1,4,23.96,36.12,14.74,23,141,164
2011-07-23 09:00:00,1,3,23.47,91.09,30.14,3,113,116
2011-07-23 10:00:00,2,3,21.52,74.23,38.8,23,93,116
2011-07-23 11:00:00,1,1,12.52,33.52,17.38,18,154,172
2011-07-23 12:00:00,2,2,16.13,76.38,26.27,23,99,122
2011-07-23 13:00:00,1,3,7.9,79.31,7.33,40,69,109
2011-07-23 14:00:00,3,4,11.79,90.95,1.18,44,125,169
2011-07-23 15:00:00,3,3,31.93,37.83,49.07,20,117,137
2011-07-23 16:00:00,3,3,34.39,99.1,14.99,16,126,142
2011-07-23 17:00:00,3,2,24.43,32.27,13.95,7,187,194
2011-07-23 18:00:00,2,3,32.5,68.06,48.66,30,69,99
2011-07-23 19:00:00,2,1,24.28,72.57,36.41,18,142,160
2011-07-23 20:00:00,4,4,6.0,53.52,29.26,10,55,65
2011-07-23 21:00:00,1,2,34.9,58.0,34.97,45,87,132
2011-07-23 22:00:00,3,4,7.97,91.27,35.5,49,189,238
2011-07-23 23:00:00,2,1,25.48,71.62,38.17,22,12,34
2011-07-24 00:00:00,1,1,12.59,59.76,3.36,36,134,170
2011-07-24 01:00:00,1,3,16.76,30.27,20.64,27,108,135
2011-07-24 02:00:00,2,3,24.38,20.59,14.76,22,148,170
2011-07-24 03:00:00,3,3,18.09,30.0,3.53,11,101,112
2011-07-24 04:00:00,4,4,12.52,96.49,20.63,15,101,116
2011-07-24 05:00:00,1,1,15.03,81.13,30.81,15,141,156
2011-07-24 06:00:00,4,2,15.25,97.37,8.92,13,2,15
2011-07-24 07:00:00,3,3,33.78,22.86,15.25,6,62,68
2011-07-24 08:00:00,3,4,28.96,74.42,31.96,20,170,190
2011-07-24 09:00:00,4,3,18.76,23.54,28.97,20,108,128
2011-07-24 10:00:00,3,1,10.99,82.56,43.44,40,11,51
2011-07-24 11:00:00,1,2,29.33,50.48,39.56,34,54,88
2011-07-24 12:00:00,4,1,9.72,27.66,48.28,45,186,231
2011-07-24 13:00:00,3,4,11.31,65.44,29.86,23,117,140
2011-07-24 14:00:00,4,3,15.98,42.41,34.92,0,147,147
2011-07-24 15:00:00,1,1,31.41,72.77,43.03,13,123,136
2011-07-24 16:00:00,3,4,8.95,72.65,42.0,19,90,109
2011-07-24 17:00:00,1,3,8.67,76.4,35.94,27,68,95
2011-07-24 18:00:00,3,2,19.82,99.4,25.01,17,172,189
2011-07-24 19:00:00,2,1,13.29,50.94,13.66,2,54,56
2011-07-24 20:00:00,3,3,22.06,57.23,43.86,26,186,212
2011-07-24 21:00:00,4,3,18.55,84.37,38.83,5,74,79
2011-07-24 22:00:00,3,3,18.05,66.27,41.9,3,59,62
2011-07-24 23:00:00,1,3,8.36,22.98,7.04,0,188,188
2011-07-25 00:00:00,1,1,9.23,87.45,15.74,20,41,61
2011-07-25 01:00:00,3,3,29.63,24.12,21.24,34,171,205
2011-07-25 02:00:00,4,4,31.58,33.67,41.92,27,133,160
2011-07-25 03:00:00,2,1,12.04,28.17,44.64,17,68,85
2011-07-25 04:00:00,4,3,8.4,26.23,14.24,34,21,55
2011-07-25 05:00:00,2,1,6.6,22.05,34.32,20,64,84
2011-07-25 06:00:00,1,4,23.25,24.4,3.89,15,83,98
2011-07-25 07:00:00,4,4,26.46,55.4,20.48,25,87,112
2011-07-25 08:00:00,2,1,16.18,40.23,24.33,38,147,185
2011-07-25 09:00:00,3,3,25.39,30.12,38.28,8,46,54
2011-07-25 10:00:00,1,3,26.39,72.7,44.6,22,175,197
2011-07-25 11:00:00,3,4,33.06,38.09,16.86,1,23,24
2011-07-25 12:00:00,1,3,6.95,21.52,26.39,2,71,73
2011-07-25 13:00:00,4,4,10.77,53.47,32.37,32,97,129
2011-07-25 14:00:00,4,3,7.06,44.83,16.43,23,38,61
2011-07-25 15:00:00,1,4,31.04,45.49,49.28,22,54,76
2011-07-25 16:00:00,1,2,28.78,55.62,43.79,5,115,120
2011-07-25 17:00:00,1,3,22.24,73.51,14.82,20,182,202
2011-07-25 18:00:00,4,3,7.51,69.32,25.4,46,197,243
2011-07-25 19:00:00,2,3,13.2,94.98,11.54,4,190,194
2011-07-25 20:00:00,3,1,13.93,61.42,25.73,12,76,88
2011-07-25 21:00:00,3,3,21.82,57.81,34.17,39,107,146
2011-07-25 22:00:00,4,1,12.74,37.07,4.28,12,146,158
2011-07-25 23:00:00,3,1,7.19,80.43,43.51,18,57,75
2011-07-26 00:00:00,1,4,26.92,31.26,29.69,8,153,161
2011-07-26 01:00:00,2,1,13.97,59.29,49.48,2,100,102
2011-07-26 02:00:00,3,1,18.57,53.71,1.28,30,90,120
2011-07-26 03:00:00,2,2,8.83,72.66,41.57,45,87,132
2011-07-26 04:00:00,1,3,29.08,93.41,39.6,38,174,212
2011-07-26 05:00:00,3,1,21.97,95.73,6.64,12,141,153
2011-07-26 06:00:00,4,3,32.05,33.42,16.77,40,130,170
2011-07-26 07:00:00,2,1,19.86,40.95,44.24,10,196,206
2011-07-26 08:00:00,1,4,33.24,84.93,25.92,40,126,166
2011-07-26 09:00:00,2,2,31.76,61.46,20.06,10,141,151
2011-07-26 10:00:00,3,1,22.29,56.24,45.27,45,7,52
2011-07-26 11:00:00,3,3,33.02,76.85,4.67,46,14,60
2011-07-26 12:00:00,4,4,14.69,68.15,23.66,48,172,220
2011-07-26 13:00:00,1,3,15.97,97.66,32.62,0,172,172
2011-07-26 14:00:00,1,4,6.36,66.72,30.43,34,2,36
2011-07-26 15:00:00,4,2,22.68,57.28,13.21,34,108,142
2011-07-26 16:00:00,4,4,26.66,63.43,28.17,2,138,140
2011-07-26 17:00:00,1,3,28.21,84.68,35.43,3,8,11
2011-07-26 18:00:00,2,3,9.49,69.01,29.24,23,3,26
2011-07-26 19:00:00,2,1,18.32,71.76,34.22,29,112,141
2011-07-26 20:00:00,4,4,10.31,97.72,12.8,31,177,208
2011-07-26 21:00:00,2,3,24.86,69.47,41.64,48,79,127
2011-07-26 22:00:00,1,1,9.74,50.42,22.48,19,133,152
2011-07-26 23:00:00,3,2,32.12,75.31,49.36,35,171,206
2011-07-27 00:00:00,3,3,11.92,72.76,1.16,12,4,16
2011-07-27 01:00:00,2,1,13.74,21.11,19.02,38,184,222
2011-07-27 02:00:00,4,3,30.53,57.39,9.02,3,48,51
2011-07-27 03:00:00,4,4,18.75,79.43,27.78,27,82,109
2011-07-27 04:00:00,4,1,5.72,59.92,12.16,39,68,107
2011-07-27 05:00:00,4,4,19.84,82.37,36.87,42,155,197
2011-07-27 06:00:00,4,2,7.54,56.07,44.09,6,119,125
2011-07-27 07:00:00,2,4,34.56,98.67,10.54,8,166,174
2011-07-27 08:00:00,3,1,22.64,43.43,8.03,21,161,182
2011-07-27 09:00:00,3,3,12.7,27.37,43.77,3,189,192
2011-07-27 10:00:00,2,1,21.91,54.4,18.06,35,11,46
2011-07-27 11:00:00,4,4,7.31,63.34,21.73,32,196,228
2011-07-27 12:00:00,2,4,29.0,47.93,11.05,5,53,58
2011-07-27 13:00:00,3,3,32.76,39.38,21.27,2,103,105
2011-07-27 14:00:00,1,2,31.23,73.76,11.57,34,79,113
2011-07-27 15:00:00,2,1,15.25,50.17,33.3,32,72,104
2011-07-27 16:00:00,4,3,14.77,70.51,24.94,6,164,170
2011-07-27 17:00:00,3,3,6.05,82.33,39.4,40,160,200
2011-07-27 18:00:00,3,3,24.54,80.88,15.64,34,176,210
2011-07-27 19:00:00,3,1,21.05,50.02,25.28,46,0,46
2011-07-27 20:00:00,3,1,18.78,65.43,12.98,2,174,176
2011-07-27 21:00:00,4,1,32.23,55.97,46.72,42,164,206
2011-07-27 22:00:00,1,2,10.04,89.66,26.1,17,136,153
2011-07-27 23:00:00,3,3,5.29,90.3,8.67,2,17,19
2011-07-28 00:00:00,2,4,7.2,47.5,13.64,38,101,139
2011-07-28 01:00:00,1,4,11.7,27.34,4.15,26,84,110
2011-07-28 02:00:00,3,3,6.0,33.41,1.39,8,171,179
2011-07-28 03:00:00,1,4,20.09,49.36,26.3,16,114,130
2011-07-28 04:00:00,2,2,14.42,65.14,16.86,40,197,237
2011-07-28 05:00:00,3,2,10.41,72.54,48.19,41,62,103
2011-07-28 06:00:00,2,1,27.5,46.51,8.57,44,2,46
2011-07-28 07:00:00,4,1,11.13,73.4,39.7,4,111,115
2011-07-28 08:00:00,3,1,25.63,95.02,15.8,45,145,190
2011-07-28 09:00:00,3,1,15.48,72.16,11.18,3,164,167
2011-07-28 10:00:00,3,1,20.35,32.69,48.48,13,19,32
2011-07-28 11:00:00,3,4,33.02,66.37,40.13,28,92,120
2011-07-28 12:00:00,4,4,6.12,63.35,31.53,10,35,45
2011-07-28 13:00:00,3,1,20.01,89.66,34.86,21,3,24
2011-07-28 14:00:00,1,2,30.63,48.02,49.57,41,119,160
2011-07-28 15:00:00,3,4,22.64,53.84,29.66,4,108,112
2011-07-28 16:00:00,4,2,13.31,67.89,5.1,11,77,88
2011-07-28 17:00:00,3,2,16.93,61.95,3.24,20,16,36
2011-07-28 18:00:00,1,3,25.41,77.52,33.33,14,184,198
2011-07-28 19:00:00,4,3,31.72,23.23,32.88,23,48,71
2011-07-28 20:00:00,4,1,6.23,65.08,37.41,12,108,120
2011-07-28 21:00:00,1,2,7.15,29.73,5.44,31,180,211
2011-07-28 22:00:00,1,4,14.75,45.22,47.25,25,115,140
2011-07-28 23:00:00,1,3,11.98,72.93,27.56,39,9,48
2011-07-29 00:00:00,1,3,12.95,32.59,32.48,25,156,181
2011-07-29 01:00:00,1,2,11.64,44.71,1.74,35,119,154
2011-07-29 02:00:00,4,3,10.87,76.24,48.05,44,122,166
2011-07-29 03:00:00,4,3,8.92,72.06,28.13,29,75,104
2011-07-29 04:00:00,3,4,33.02,27.28,28.17,46,122,168
2011-07-29 05:00:00,3,2,9.33,66.18,47.18,8,136,144
2011-07-29 06:00:00,2,3,11.13,31.78,46.47,23,89,112
2011-07-29 07:00:00,3,2,12.39,40.18,11.01,37,148,185
2011-07-29 08:00:00,3,3,32.99,56.74,46.55,17,0,17
2011-07-29 09:00:00,1,4,27.67,28.75,36.83,8,163,171
2011-07-29 10:00:00,1,2,28.69,99.49,0.95,21,5,26
2011-07-29 11:00:00,3,3,8.14,33.23,11.99,37,110,147
2011-07-29 12:00:00,2,4,30.09,82.51,20.65,20,145,165
2011-07-29 13:00:00,1,3,17.25,86.39,29.14,6,100,106
2011-07-29 14:00:00,3,2,12.88,99.56,35.07,11,199,210
2011-07-29 15:00:00,3,3,22.27,54.29,10.51,35,138,173
2011-07-29 16:00:00,4,2,29.67,89.93,41.84,10,68,78
2011-07-29 17:00:00,2,2,28.36,96.6,42.29,2,148,150
2011-07-29 18:00:00,4,3,31.7,33.83,31.75,26,106,132
2011-07-29 19:00:00,2,4,32.84,58.35,46.05,6,105,111
2011-07-29 20:00:00,1,1,12.14,24.8,40.65,1,8,9
2011-07-29 21:00:00,2,4,17.72,69.66,11.08,9,1,10
2011-07-29 22:00:00,3,4,5.44,66.51,39.93,2,112,114
2011-07-29 23:00:00,3,3,31.38,36.33,47.66,16,131,147
2011-07-30 00:00:00,2,4,9.64,83.83,6.88,42,89,131
2011-07-30 01:00:00,2,4,30.84,22.98,48.93,0,11,11
2011-07-30 02:00:00,2,1,14.88,84.5,1.25,33,82,115
2011-07-30 03:00:00,4,4,16.04,22.13,26.11,12,82,94
2011-07-30 04:00:00,2,1,6.17,72.55,38.69,13,92,105
2011-07-30 05:00:00,1,3,14.81,26.3,39.52,16,38,54
2011-07-30 06:00:00,4,1,31.65,40.1,36.73,33,187,220
2011-07-30 07:00:00,4,2,5.77,77.75,26.47,16,161,177
2011-07-30 08:00:00,2,2,17.19,42.43,32.55,40,58,98
2011-07-30 09:00:00,1,1,5.94,60.89,35.0,24,127,151
2011-07-30 10:00:00,4,2,16.13,93.22,24.73,43,71,114
2011-07-30 11:00:00,3,3,10.18,23.97,29.78,29,133,162
2011-07-30 12:00:00,4,2,12.57,84.89,42.32,47,159,206
2011-07-30 13:00:00,2,1,31.33,25.22,15.64,35,27,62
2011-07-30 14:00:00,1,3,18.08,30.14,26.16,10,74,84
2011-07-30 15:00:00,2,2,13.21,29.55,0.42,20,40,60
2011-07-30 16:00:00,3,3,22.68,99.53,34.37,19,71,90
2011-07-30 17:00:00,3,1,9.26,34.41,9.77,28,87,115
2011-07-30 18:00:00,3,2,12.78,91.74,24.05,3,154,157
2011-07-30 19:00:00,2,3,21.39,99.27,10.51,33,52,85
2011-07-30 20:00:00,4,3,12.13,50.7,1.18,41,122,163
2011-07-30 21:00:00,2,2,25.37,70.48,24.16,40,10,50
2011-07-30 22:00:00,1,3,19.74,82.33,21.24,16,86,102
2011-07-30 23:00:00,4,3,28.16,51.41,21.26,11,149,160
2011-07-31 00:00:00,3,1,33.45,32.95,10.44,3,4,7
2011-07-31 01:00:00,2,1,8.47,54.7,47.36,40,111,151
2011-07-31 02:00:00,3,1,15.04,81.75,0.18,13,161,174
2011-07-31 03:00:00,3,1,14.59,82.46,44.58,3,61,64
2011-07-31 04:00:00,1,1,9.54,38.44,36.85,33,158,191
2011-07-31 05:00:00,4,1,29.31,34.0,8.6,17,46,63
2011-07-31 06:00:00,1,2,27.8,93.64,23.61,12,36,48
2011-07-31 07:00:00,1,1,19.53,23.52,49.44,9,110,119
2011-07-31 08:00:00,1,3,21.13,78.78,32.18,13,25,38
2011-07-31 09:00:00,3,2,6.79,23.71,6.37,8,42,50
2011-07-31 10:00:00,1,3,21.67,87.03,22.88,42,60,102
2011-07-31 11:00:00,1,1,28.74,92.43,23.41,19,165,184
2011-07-31 12:00:00,4,1,22.21,43.79,40.11,0,127,127
2011-07-31 13:00:00,4,3,12.96,25.91,45.81,43,159,202
2011-07-31 14:00:00,1,3,25.03,58.45,4.11,28,68,96
2011-07-31 15:00:00,4,3,15.84,43.88,15.7,16,189,205
2011-07-31 16:00:00,4,4,21.35,53.37,14.92,48,125,173
2011-07-31 17:00:00,1,4,19.63,73.2,49.8,7,126,133
2011-07-31 18:00:00,3,4,16.44,36.79,27.96,16,152,168
2011-07-31 19:00:00,1,4,26.57,48.56,43.99,20,32,52
2011-07-31 20:00:00,4,2,31.52,82.6,21.3,24,63,87
2011-07-31 21:00:00,3,1,5.16,71.5,36.14,19,198,217
2011-07-31 22:00:00,2,3,33.01,46.1,14.33,24,143,167
2011-07-31 23:00:00,3,1,20.35,73.14,45.59,20,176,196
2011-08-01 00:00:00,4,3,26.02,81.23,22.76,12,92,104
2011-08-01 01:00:00,3,1,30.67,67.4,40.19,12,122,134
2011-08-01 02:00:00,1,2,19.01,39.16,12.79,46,14,60
2011-08-01 03:00:00,2,4,30.05,20.02,34.68,49,19,68
2011-08-01 04:00:00,2,1,10.33,84.23,20.26,29,21,50
2011-08-01 05:00:00,2,3,9.78,85.81,1.57,12,9,21
2011-08-01 06:00:00,4,1,24.72,75.81,20.65,39,199,238
2011-08-01 07:00:00,4,2,31.1,26.13,27.5,6,182,188
2011-08-01 08:00:00,2,2,31.77,66.82,7.59,41,95,136
2011-08-01 09:00:00,3,1,24.31,85.68,9.2,11,155,166
2011-08-01 10:00:00,2,4,20.76,51.17,23.24,1,136,137
2011-08-01 11:00:00,3,3,14.94,35.84,17.14,13,30,43
2011-08-01 12:00:00,3,2,34.4,67.01,22.04,41,95,136
2011-08-01 13:00:00,4,2,14.59,86.1,23.04,16,73,89
2011-08-01 14:00:00,3,1,27.33,23.91,7.0,12,184,196
2011-08-01 15:00:00,2,2,20.96,67.76,9.06,0,158,158
2011-08-01 16:00:00,4,2,23.26,71.45,42.41,46,74,120
2011-08-01 17:00:00,1,3,16.8,68.19,8.14,0,170,170
2011-08-01 18:00:00,1,4,33.94,72.0,33.3,46,73,119
2011-08-01 19:00:00,4,3,22.15,70.51,20.93,25,136,161
2011-08-01 20:00:00,2,4,33.13,30.43,48.41,46,41,87
2011-08-01 21:00:00,1,3,5.23,38.79,3.31,45,73,118
2011-08-01 22:00:00,1,1,22.18,69.52,41.52,12,177,189
2011-08-01 23:00:00,3,2,26.52,21.42,24.57,33,164,197
2011-08-02 00:00:00,3,4,27.35,70.78,0.27,39,198,237
2011-08-02 01:00:00,2,1,32.15,73.23,13.18,8,83,91
2011-08-02 02:00:00,4,2,5.13,39.13,20.38,18,199,217
2011-08-02 03:00:00,2,2,5.01,67.85,15.71,22,144,166
2011-08-02 04:00:00,4,2,19.17,62.73,18.12,40,175,215
2011-08-02 05:00:00,1,3,5.88,40.86,45.83,27,1,28
2011-08-02 06:00:00,3,1,34.24,57.04,18.05,29,41,70
2011-08-02 07:00:00,2,1,11.66,92.77,20.94,6,105,111
2011-08-02 08:00:00,2,2,19.18,54.13,38.06,13,190,203
2011-08-02 09:00:00,4,4,6.83,70.39,39.69,1,138,139
2011-08-02 10:00:00,4,1,20.66,22.83,4.2,11,126,137
2011-08-02 11:00:00,2,3,16.4,26.22,35.2,42,183,225
2011-08-02 12:00:00,4,4,6.34,26.5,24.13,48,72,120
2011-08-02 13:00:00,2,4,15.05,82.26,6.69,1,172,173
2011-08-02 14:00:00,2,4,16.74,48.02,13.24,27,172,199
2011-08-02 15:00:00,2,4,34.7,38.21,2.25,27,156,183
2011-08-02 16:00:00,1,1,11.24,79.79,18.01,11,161,172
2011-08-02 17:00:00,4,2,21.34,33.6,12.77,29,196,225
2011-08-02 18:00:00,3,4,34.62,39.72,19.11,46,94,140
2011-08-02 19:00:00,3,3,28.76,54.47,29.02,39,89,128
2011-08-02 20:00:00,4,3,34.8,46.52,36.62,39,120,159
2011-08-02 21:00:00,2,2,34.05,66.83,30.27,21,19,40
2011-08-02 22:00:00,3,1,19.69,47.03,33.92,17,71,88
2011-08-02 23:00:00,3,2,25.89,51.44,43.28,13,69,82
2011-08-03 00:00:00,4,4,8.31,89.03,43.69,24,145,169
2011-08-03 01:00:00,3,1,18.23,90.76,43.04,9,199,208
2011-08-03 02:00:00,2,1,29.27,86.22,7.66,35,187,222
2011-08-03 03:00:00,4,4,20.16,89.19,12.55,47,116,163
2011-08-03 04:00:00,2,3,26.08,65.58,25.12,47,182,229
2011-08-03 05:00:00,3,4,27.37,71.7,17.94,48,51,99
2011-08-03 06:00:00,3,2,12.6,64.57,6.58,8,24,32
2011-08-03 07:00:00,2,4,31.27,82.85,14.39,10,65,75
2011-08-03 08:00:00,1,3,18.79,64.08,48.77,26,27,53
2011-08-03 09:00:00,3,4,11.31,28.89,17.35,12,88,100
2011-08-03 10:00:00,1,2,30.96,84.77,20.95,0,19,19
2011-08-03 11:00:00,3,2,17.53,80.85,0.32,38,69,107
2011-08-03 12:00:00,1,3,27.51,85.62,35.97,10,36,46
2011-08-03 13:00:00,1,2,21.44,35.23,20.68,2,15,17
2011-08-03 14:00:00,1,2,16.46,41.73,5.16,1,162,163
2011-08-03 15:00:00,2,4,29.3,43.66,48.43,45,182,227
2011-08-03 16:00:00,1,1,22.53,60.65,38.87,41,99,140
2011-08-03 17:00:00,1,2,16.72,30.71,36.31,23,192,215
2011-08-03 18:00:00,1,2,8.29,50.83,47.89,19,77,96
2011-08-03 19:00:00,3,3,31.86,34.57,20.37,48,13,61
2011-08-03 20:00:00,1,3,6.06,41.18,35.93,39,23,62
2011-08-03 21:00:00,3,4,30.9,76.51,10.31,14,82,96
2011-08-03 22:00:00,1,4,15.8,88.38,34.86,5,37,42
2011-08-03 23:00:00,1,2,24.18,21.83,0.7,19,81,100
2011-08-04 00:00:00,2,1,32.67,65.27,6.32,21,8,29
2011-08-04 01:00:00,3,1,9.55,22.88,21.26,1,120,121
2011-08-04 02:00:00,1,4,22.01,26.82,0.6,14,58,72
2011-08-04 03:00:00,3,3,27.93,76.41,23.1,47,50,97
2011-08-04 04:00:00,3,2,27.73,78.85,26.14,33,108,141
2011-08-04 05:00:00,4,2,20.77,85.12,31.08,45,50,95
2011-08-04 06:00:00,2,1,23.74,57.94,5.02,30,18,48
2011-08-04 07:00:00,2,4,27.73,88.78,9.05,29,61,90
2011-08-04 08:00:00,2,1,30.23,33.35,30.66,27,9,36
2011-08-04 09:00:00,4,1,27.85,39.98,32.91,32,165,197
2011-08-04 10:00:00,4,4,15.62,30.76,1.3,40,130,170
2011-08-04 11:00:00,2,3,34.9,83.8,27.02,48,175,223
2011-08-04 12:00:00,4,2,18.04,38.29,39.25,20,168,188
2011-08-04 13:00:00,4,3,5.73,32.44,3.46,45,144,189
2011-08-04 14:00:00,4,4,15.88,69.85,20.66,22,86,108
2011-08-04 15:00:00,2,4,8.83,26.17,16.33,41,72,113
2011-08-04 16:00:00,2,2,8.64,23.59,45.68,12,196,208
2011-08-04 17:00:00,2,3,13.45,28.54,9.29,44,82,126
2011-08-04 18:00:00,4,2,6.6,20.02,15.92,25,92,117
2011-08-04 19:00:00,2,1,25.66,75.76,44.92,18,14,32
2011-08-04 20:00:00,4,1,7.22,64.98,16.53,26,105,131
2011-08-04 21:00:00,1,1,11.1,36.79,26.57,39,99,138
2011-08-04 22:00:00,4,3,7.79,38.64,1.65,6,183,189
2011-08-04 23:00:00,3,1,6.9,84.88,49.25,24,75,99
2011-08-05 00:00:00,2,2,13.03,60.15,41.25,48,77,125
2011-08-05 01:00:00,2,3,22.16,75.88,31.72,39,142,181
2011-08-05 02:00:00,3,2,33.94,56.22,3.04,35,114,149
2011-08-05 03:00:00,4,4,31.27,39.02,3.74,6,94,100
2011-08-05 04:00:00,1,3,31.28,97.63,27.25,19,132,151
2011-08-05 05:00:00,3,2,10.28,65.25,14.25,23,43,66
2011-08-05 06:00:00,3,2,12.95,30.48,31.14,27,2,29
2011-08-05 07:00:00,4,3,7.29,52.49,29.91,48,46,94
2011-08-05 08:00:00,2,4,28.35,46.35,41.93,4,157,161
2011-08-05 09:00:00,4,3,7.09,37.13,14.07,35,11,46
2011-08-05 10:00:00,3,1,21.7,94.68,28.89,30,14,44
2011-08-05 11:00:00,3,1,12.44,90.47,38.87,32,165,197
2011-08-05 12:00:00,2,4,12.3,35.93,24.54,23,27,50
2011-08-05 13:00:00,2,2,34.72,48.17,41.53,9,176,185
2011-08-05 14:00:00,2,2,27.7,80.99,6.56,37,86,123
2011-08-05 15:00:00,4,2,30.11,36.68,36.69,43,174,217
2011-08-05 16:00:00,2,3,22.16,67.33,47.15,48,74,122
2011-08-05 17:00:00,3,3,31.13,75.98,16.59,4,93,97
2011-08-05 18:00:00,3,4,24.36,72.32,18.32,30,11,41
2011-08-05 19:00:00,1,1,33.39,76.51,4.18,8,53,61
2011-08-05 20:00:00,4,2,13.44,76.54,32.07,31,82,113
2011-08-05 21:00:00,1,1,22.86,97.18,27.62,40,31,71
2011-08-05 22:00:00,3,3,25.7,47.72,2.02,4,128,132
2011-08-05 23:00:00,1,3,16.79,90.29,37.61,26,143,169
2011-08-06 00:00:00,3,3,31.39,21.74,41.46,27,10,37
2011-08-06 01:00:00,1,1,34.39,43.06,45.36,42,96,138
2011-08-06 02:00:00,2,4,19.81,23.89,27.29,11,54,65
2011-08-06 03:00:00,1,4,16.72,72.1,22.63,4,163,167
2011-08-06 04:00:00,2,3,19.16,28.06,43.81,7,29,36
2011-08-06 05:00:00,2,2,30.58,87.66,19.93,16,67,83
2011-08-06 06:00:00,4,1,24.36,71.73,32.77,7,55,62
2011-08-06 07:00:00,2,3,6.34,22.31,30.77,33,187,220
2011-08-06 08:00:00,2,1,21.27,77.18,18.61,22,88,110
2011-08-06 09:00:00,1,1,5.52,88.96,4.34,17,97,114
2011-08-06 10:00:00,3,4,28.36,72.89,1.07,9,16,25
2011-08-06 11:00:00,4,3,14.85,22.44,21.41,38,160,198
2011-08-06 12:00:00,2,4,19.16,88.63,24.06,40,157,197
2011-08-06 13:00:00,4,3,28.96,78.6,41.13,43,12,55
2011-08-06 14:00:00,1,1,6.39,50.28,20.72,43,139,182
2011-08-06 15:00:00,2,4,9.76,46.29,14.06,4,123,127
2011-08-06 16:00:00,1,1,16.94,58.39,23.1,42,31,73
2011-08-06 17:00:00,4,3,11.9,89.37,11.9,16,86,102
2011-08-06 18:00:00,1,2,15.14,40.16,4.57,46,92,138
2011-08-06 19:00:00,4,4,34.95,28.08,5.65,10,33,43
2011-08-06 20:00:00,1,4,29.76,89.17,15.96,46,82,128
2011-08-06 21:00:00,4,1,31.52,22.1,0.63,47,11,58
2011-08-06 22:00:00,3,1,33.11,92.88,11.01,18,3,21
2011-08-06 23:00:00,1,2,15.23,44.46,39.38,20,88,108
2011-08-07 00:00:00,1,4,13.91,60.66,11.73,43,153,196
2011-08-07 01:00:00,3,3,12.02,30.58,5.54,2,81,83
2011-08-07 02:00:00,3,3,29.9,92.18,47.45,39,191,230
2011-08-07 03:00:00,1,4,25.39,79.99,31.12,42,127,169
2011-08-07 04:00:00,3,4,12.09,93.93,3.0,0,157,157
2011-08-07 05:00:00,2,4,16.31,74.66,3.11,23,121,144
2011-08-07 06:00:00,4,2,20.2,34.78,30.61,35,161,196
2011-08-07 07:00:00,4,3,20.84,44.66,27.01,5,32,37
2011-08-07 08:00:00,4,3,31.66,58.95,3.42,9,158,167
2011-08-07 09:00:00,2,1,16.42,68.58,11.22,46,55,101
2011-08-07 10:00:00,3,1,32.26,94.12,46.45,39,61,100
2011-08-07 11:00:00,3,4,18.24,50.72,28.6,45,30,75
2011-08-07 12:00:00,1,1,27.39,76.25,22.02,33,23,56
2011-08-07 13:00:00,3,2,32.91,96.88,12.51,23,68,91
2011-08-07 14:00:00,1,3,32.23,32.19,6.68,22,178,200
2011-08-07 15:00:00,2,3,6.71,89.02,20.13,19,192,211
2011-08-07 16:00:00,4,1,11.17,53.66,46.12,37,97,134
2011-08-07 17:00:00,4,4,19.31,78.59,2.44,34,8,42
2011-08-07 18:00:00,4,1,17.95,43.48,49.55,33,7,40
2011-08-07 19:00:00,3,4,24.23,46.72,10.39,45,106,151
2011-08-07 20:00:00,1,2,33.34,22.17,20.44,49,163,212
2011-08-07 21:00:00,1,3,8.37,97.71,2.25,46,92,138
2011-08-07 22:00:00,2,2,18.56,85.08,29.24,35,68,103
2011-08-07 23:00:00,3,3,10.77,27.51,24.18,15,183,198
2011-08-08 00:00:00,2,2,31.82,99.96,33.34,22,45,67
2011-08-08 01:00:00,1,1,33.94,68.4,27.13,43,137,180
2011-08-08 02:00:00,1,2,19.36,88.3,19.91,48,101,149
2011-08-08 03:00:00,4,2,8.12,25.33,36.89,0,73,73
2011-08-08 04:00:00,3,1,28.56,51.16,1.25,8,126,134
2011-08-08 05:00:00,1,3,25.91,73.57,27.05,11,138,149
2011-08-08 06:00:00,4,3,15.64,28.51,5.69,36,115,151
2011-08-08 07:00:00,3,1,31.62,59.11,21.8,16,7,23
2011-08-08 08:00:00,2,2,34.27,55.41,39.56,2,67,69
2011-08-08 09:00:00,3,2,21.74,37.28,7.12,37,145,182
2011-08-08 10:00:00,3,2,21.97,44.02,46.79,28,127,155
2011-08-08 11:00:00,1,4,13.93,97.37,44.43,30,121,151
2011-08-08 12:00:00,1,3,22.54,43.09,20.75,34,2,36
2011-08-08 13:00:00,3,2,18.19,37.07,0.3,37,107,144
2011-08-08 14:00:00,1,3,14.07,62.9,39.49,25,142,167
2011-08-08 15:00:00,1,2,7.02,73.68,44.04,12,187,199
2011-08-08 16:00:00,1,1,12.58,78.01,8.74,18,127,145
2011-08-08 17:00:00,4,1,10.94,80.34,45.81,31,119,150
2011-08-08 18:00:00,4,3,21.26,22.95,45.7,46,199,245
2011-08-08 19:00:00,3,3,23.05,51.5,23.56,26,54,80
2011-08-08 20:00:00,1,1,23.26,81.92,39.9,38,69,107
2011-08-08 21:00:00,4,4,16.65,92.39,22.25,12,120,132
2011-08-08 22:00:00,3,1,17.64,68.18,28.2,33,99,132
2011-08-08 23:00:00,1,2,30.03,24.18,15.99,18,31,49
2011-08-09 00:00:00,2,4,19.29,51.73,7.97,18,5,23
2011-08-09 01:00:00,1,1,34.63,25.94,37.33,2,143,145
2011-08-09 02:00:00,1,4,18.19,79.88,0.07,2,193,195
2011-08-09 03:00:00,4,4,24.49,25.08,28.98,25,15,40
2011-08-09 04:00:00,3,4,6.51,34.86,43.23,5,13,18
2011-08-09 05:00:00,3,3,24.6,53.36,11.06,12,61,73
2011-08-09 06:00:00,4,1,30.54,57.01,16.64,45,145,190
2011-08-09 07:00:00,1,3,33.27,52.52,29.37,37,7,44
2011-08-09 08:00:00,2,3,34.92,57.07,12.34,26,132,158
2011-08-09 09:00:00,1,2,13.47,77.06,42.37,40,87,127
2011-08-09 10:00:00,1,2,22.26,49.54,18.33,23,40,63
2011-08-09 11:00:00,2,4,18.52,63.82,29.08,9,110,119
2011-08-09 12:00:00,4,4,21.91,44.27,11.31,15,58,73
2011-08-09 13:00:00,3,2,9.72,48.29,2.07,22,8,30
2011-08-09 14:00:00,4,2,30.68,69.1,8.69,46,41,87
2011-08-09 15:00:00,4,1,32.29,59.24,2.31,11,17,28
2011-08-09 16:00:00,1,4,18.49,77.84,23.43,27,45,72
2011-08-09 17:00:00,3,4,13.41,64.84,29.33,12,122,134
2011-08-09 18:00:00,3,2,9.23,84.29,2.23,17,175,192
2011-08-09 19:00:00,4,1,25.51,55.47,4.52,1,27,28
2011-08-09 20:00:00,2,2,14.37,59.28,24.28,45,36,81
2011-08-09 21:00:00,4,2,32.29,73.6,39.96,16,73,89
2011-08-09 22:00:00,2,3,25.13,37.7,31.4,22,19,41
2011-08-09 23:00:00,3,4,24.37,50.87,5.24,22,165,187
2011-08-10 00:00:00,4,1,21.78,69.99,44.38,0,168,168
2011-08-10 01:00:00,1,3,6.37,22.31,45.87,42,111,153
2011-08-10 02:00:00,4,4,32.96,54.96,16.25,13,123,136
2011-08-10 03:00:00,3,2,23.84,67.91,30.8,11,189,200
2011-08-10 04:00:00,1,1,34.82,97.39,24.62,13,147,160
2011-08-10 05:00:00,1,4,21.12,90.16,47.1,48,150,198
2011-08-10 06:00:00,2,2,26.3,42.46,25.44,43,49,92
2011-08-10 07:00:00,1,3,6.69,60.58,48.0,37,132,169
2011-08-10 08:00:00,1,1,23.95,24.51,9.97,40,187,227
2011-08-10 09:00:00,4,4,27.94,39.26,17.28,43,72,115
2011-08-10 10:00:00,3,3,28.36,81.99,39.07,48,42,90
2011-08-10 11:00:00,2,2,28.1,29.87,39.18,15,125,140
2011-08-10 12:00:00,4,2,11.79,40.62,36.61,33,104,137
2011-08-10 13:00:00,1,4,34.26,95.52,42.98,17,35,52
2011-08-10 14:00:00,1,2,34.86,85.91,35.13,47,100,147
2011-08-10 15:00:00,2,1,7.27,82.55,31.8,9,2,11
2011-08-10 16:00:00,3,4,33.09,89.16,22.95,18,188,206
2011-08-10 17:00:00,2,3,13.68,79.97,23.35,29,181,210
2011-08-10 18:00:00,4,4,25.68,29.65,20.31,3,35,38
2011-08-10 19:00:00,2,4,15.14,61.32,31.01,6,111,117
2011-08-10 20:00:00,1,3,34.03,55.54,20.33,15,44,59
2011-08-10 21:00:00,4,2,8.05,44.89,7.37,36,99,135
2011-08-10 22:00:00,1,3,19.93,86.72,5.33,4,156,160
2011-08-10 23:00:00,3,1,17.84,57.13,46.22,38,153,191
2011-08-11 00:00:00,1,2,14.78,24.82,1.24,48,135,183
2011-08-11 01:00:00,1,4,24.37,42.0,5.27,32,72,104
2011-08-11 02:00:00,2,2,8.93,38.29,22.27,34,149,183
2011-08-11 03:00:00,1,2,26.5,91.0,13.15,47,68,115
2011-08-11 04:00:00,4,1,34.42,71.8,20.29,33,171,204
2011-08-11 05:00:00,4,2,29.14,64.83,5.87,32,168,200
2011-08-11 06:00:00,3,2,30.8,60.53,6.55,38,163,201
2011-08-11 07:00:00,4,2,15.79,72.01,40.03,9,157,166
2011-08-11 08:00:00,2,4,14.75,80.39,37.96,2,48,50
2011-08-11 09:00:00,3,2,20.51,64.35,5.21,49,108,157
2011-08-11 10:00:00,4,3,6.37,95.06,33.39,28,118,146
2011-08-11 11:00:00,2,2,33.36,98.15,30.47,34,16,50
2011-08-11 12:00:00,4,1,9.31,99.63,35.67,30,157,187
2011-08-11 13:00:00,4,2,32.09,73.55,23.72,38,123,161
2011-08-11 14:00:00,1,2,7.51,94.61,13.5,14,3,17
2011-08-11 15:00:00,4,4,29.68,52.36,33.18,0,162,162
2011-08-11 16:00:00,4,3,9.56,88.77,18.57,18,83,101
2011-08-11 17:00:00,2,2,6.14,92.73,10.95,36,144,180
2011-08-11 18:00:00,2,3,26.58,92.33,20.43,26,134,160
2011-08-11 19:00:00,1,1,13.41,86.47,38.16,20,102,122
2011-08-11 20:00:00,4,4,26.43,52.53,23.79,6,116,122
2011-08-11 21:00:00,1,3,21.65,32.71,14.99,42,61,103
2011-08-11 22:00:00,4,4,8.26,46.72,41.59,32,57,89
2011-08-11 23:00:00,3,2,32.96,81.38,44.08,1,171,172
2011-08-12 00:00:00,3,1,18.57,38.63,21.66,13,57,70
2011-08-12 01:00:00,1,4,27.03,58.26,18.73,41,180,221
2011-08-12 02:00:00,1,2,20.03,65.23,30.63,2,105,107
2011-08-12 03:00:00,1,3,23.13,68.31,2.9,13,71,84
2011-08-12 04:00:00,2,1,14.08,94.86,34.57,4,136,140
2011-08-12 05:00:00,2,1,11.01,72.92,39.11,16,5,21
2011-08-12 06:00:00,2,3,21.28,82.9,19.87,38,18,56
2011-08-12 07:00:00,1,3,18.21,66.55,8.73,0,85,85
2011-08-12 08:00:00,4,1,16.7,86.69,1.44,42,110,152
2011-08-12 09:00:00,3,4,25.18,41.09,31.86,27,147,174
2011-08-12 10:00:00,1,1,25.72,36.79,13.45,37,63,100
2011-08-12 11:00:00,2,3,6.38,94.11,23.19,47,154,201
2011-08-12 12:00:00,2,4,15.16,75.48,19.32,13,134,147
2011-08-12 13:00:00,1,2,17.35,73.72,8.74,16,117,133
2011-08-12 14:00:00,1,1,7.91,57.38,25.42,14,23,37
2011-08-12 15:00:00,2,3,12.08,50.14,22.98,45,122,167
2011-08-12 16:00:00,4,2,6.55,64.46,31.21,6,7,13
2011-08-12 17:00:00,2,1,34.89,29.65,12.59,41,66,107
2011-08-12 18:00:00,2,1,27.1,56.38,10.73,6,10,16
2011-08-12 19:00:00,1,4,7.62,56.43,40.72,46,99,145
2011-08-12 20:00:00,4,3,5.61,63.07,35.11,23,65,88
2011-08-12 21:00:00,2,2,26.58,70.77,38.61,25,128,153
2011-08-12 22:00:00,2,1,18.18,96.59,6.16,13,6,19
2011-08-12 23:00:00,3,4,28.6,72.17,11.2,46,23,69
2011-08-13 00:00:00,1,2,32.7,90.7,28.78,18,139,157
2011-08-13 01:00:00,3,2,22.98,64.5,42.86,25,62,87
2011-08-13 02:00:00,3,1,10.61,70.15,44.61,15,71,86
2011-08-13 03:00:00,2,2,28.47,25.59,41.6,33,140,173
2011-08-13 04:00:00,1,1,33.67,30.66,2.17,1,197,198
2011-08-13 05:00:00,4,4,22.41,66.37,41.04,0,87,87
2011-08-13 06:00:00,2,4,25.46,51.66,44.95,47,115,162
2011-08-13 07:00:00,4,2,15.12,83.9,2.84,35,23,58
2011-08-13 08:00:00,4,1,16.45,63.45,20.81,34,37,71
2011-08-13 09:00:00,1,3,27.04,90.58,26.83,42,198,240
2011-08-13 10:00:00,3,4,32.83,97.79,11.64,23,9,32
2011-08-13 11:00:00,1,1,23.87,31.81,25.83,48,157,205
2011-08-13 12:00:00,4,1,28.7,51.59,44.3,4,87,91
2011-08-13 13:00:00,2,1,10.15,73.2,43.35,28,26,54
2011-08-13 14:00:00,4,2,11.36,44.44,46.99,40,29,69
2011-08-13 15:00:00,2,3,20.96,41.36,24.21,0,127,127
2011-08-13 16:00:00,2,2,10.3,85.1,20.53,8,116,124
2011-08-13 17:00:00,1,4,24.05,98.43,33.29,35,1,36
2011-08-13 18:00:00,4,2,13.75,81.9,20.84,15,7,22
2011-08-13 19:00:00,3,1,28.75,61.89,2.1,14,144,158
2011-08-13 20:00:00,4,2,29.24,55.4,36.0,9,47,56
2011-08-13 21:00:00,4,1,18.91,63.17,14.05,36,63,99
2011-08-13 22:00:00,3,3,10.42,57.03,2.45,15,188,203
2011-08-13 23:00:00,1,2,24.4,60.23,1.03,37,140,177
2011-08-14 00:00:00,4,2,34.78,36.28,46.57,47,148,195
2011-08-14 01:00:00,4,2,23.68,92.3,12.6,35,106,141
2011-08-14 02:00:00,2,1,6.07,80.36,22.39,14,129,143
2011-08-14 03:00:00,4,1,5.52,74.48,47.53,2,126,128
2011-08-14 04:00:00,3,2,14.61,95.99,23.38,18,83,101
2011-08-14 05:00:00,2,2,10.87,42.75,3.93,40,150,190
2011-08-14 06:00:00,1,3,29.39,26.49,27.6,36,15,51
2011-08-14 07:00:00,2,3,30.34,86.09,4.41,47,140,187
2011-08-14 08:00:00,3,4,12.76,99.87,4.75,2,131,133
2011-08-14 09:00:00,3,3,14.77,66.27,42.57,7,1,8
2011-08-14 10:00:00,2,3,12.09,24.7,14.47,23,113,136
2011-08-14 11:00:00,1,3,32.25,82.44,33.93,13,64,77
2011-08-14 12:00:00,2,1,20.08,25.9,25.45,34,25,59
2011-08-14 13:00:00,1,3,24.68,63.2,11.12,15,29,44
2011-08-14 14:00:00,2,3,17.46,42.2,25.89,6,117,123
2011-08-14 15:00:00,3,2,23.93,93.2,3.45,40,37,77
2011-08-14 16:00:00,4,1,16.58,56.11,17.36,34,147,181
2011-08-14 17:00:00,4,4,15.19,91.88,26.14,7,24,31
2011-08-14 18:00:00,1,4,24.03,43.93,11.42,11,124,135
2011-08-14 19:00:00,1,3,22.73,50.99,33.01,48,51,99
2011-08-14 20:00:00,1,4,13.81,95.77,2.59,45,82,127
2011-08-14 21:00:00,3,4,9.48,36.11,24.24,15,90,105
2011-08-14 22:00:00,2,4,16.06,66.28,35.75,3,137,140
2011-08-14 23:00:00,3,3,17.46,51.08,21.5,34,168,202
2011-08-15 00:00:00,4,4,23.86,81.93,43.73,44,60,104
2011-08-15 01:00:00,1,3,32.44,30.34,31.61,40,110,150
2011-08-15 02:00:00,2,2,6.09,54.98,47.92,44,1,45
2011-08-15 03:00:00,4,2,12.31,75.91,14.21,31,80,111
2011-08-15 04:00:00,4,4,10.81,52.56,46.94,11,134,145
2011-08-15 05:00:00,4,2,20.07,24.68,30.34,20,59,79
2011-08-15 06:00:00,3,3,17.89,76.41,37.26,14,188,202
2011-08-15 07:00:00,1,2,26.87,60.26,45.11,34,79,113
2011-08-15 08:00:00,4,4,12.27,20.9,27.56,2,112,114
2011-08-15 09:00:00,1,3,22.83,69.01,43.11,1,26,27
2011-08-15 10:00:00,3,1,31.52,93.59,27.08,5,0,5
2011-08-15 11:00:00,4,3,32.32,28.88,29.96,15,85,100
2011-08-15 12:00:00,3,2,33.76,67.25,22.25,22,154,176
2011-08-15 13:00:00,3,1,28.2,78.29,7.28,30,79,109
2011-08-15 14:00:00,1,3,32.18,25.66,27.68,49,59,108
2011-08-15 15:00:00,4,1,12.04,21.81,48.87,40,52,92
2011-08-15 16:00:00,3,1,10.93,57.14,39.36,29,35,64
2011-08-15 17:00:00,4,1,5.19,83.29,37.37,2,151,153
2011-08-15 18:00:00,1,3,26.21,32.86,32.17,15,34,49
2011-08-15 19:00:00,3,2,33.12,86.93,17.4,3,32,35
2011-08-15 20:00:00,1,3,10.61,72.53,8.48,45,144,189
2011-08-15 21:00:00,4,2,24.11,46.57,11.23,35,68,103
2011-08-15 22:00:00,4,3,27.39,61.27,0.32,27,162,189
2011-08-15 23:00:00,1,3,32.83,97.25,33.67,49,106,155
2011-08-16 00:00:00,2,3,24.41,37.31,40.59,49,174,223
2011-08-16 01:00:00,3,2,34.11,59.96,13.45,49,97,146
2011-08-16 02:00:00,4,3,15.34,69.96,4.59,27,95,122
2011-08-16 03:00:00,4,1,15.5,31.04,16.79,2,88,90
2011-08-16 04:00:00,3,3,21.29,23.48,14.6,25,58,83
2011-08-16 05:00:00,1,1,16.51,21.08,22.54,38,60,98
2011-08-16 06:00:00,1,4,5.04,45.98,13.21,12,149,161
2011-08-16 07:00:00,1,4,26.95,25.92,16.99,6,26,32
2011-08-16 08:00:00,2,2,27.55,84.3,45.38,12,199,211
2011-08-16 09:00:00,2,2,27.41,99.79,16.74,3,111,114
2011-08-16 10:00:00,4,4,15.35,24.9,39.28,15,89,104
2011-08-16 11:00:00,1,3,20.67,54.62,31.29,27,14,41
2011-08-16 12:00:00,3,3,15.8,22.06,16.88,46,163,209
2011-08-16 13:00:00,4,3,5.48,30.72,40.89,12,108,120
2011-08-16 14:00:00,3,4,21.87,45.83,29.75,41,184,225
2011-08-16 15:00:00,4,1,8.71,51.5,0.43,9,40,49
2011-08-16 16:00:00,2,2,7.4,95.18,3.44,4,172,176
2011-08-16 17:00:00,4,1,27.66,51.67,37.63,35,170,205
2011-08-16 18:00:00,2,4,5.29,59.7,22.33,18,11,29
2011-08-16 19:00:00,4,1,33.77,39.65,20.28,29,195,224
2011-08-16 20:00:00,1,3,20.46,20.01,7.29,46,194,240
2011-08-16 21:00:00,3,3,34.49,91.95,7.87,40,95,135
2011-08-16 22:00:00,1,1,6.74,26.54,39.89,47,3,50
2011-08-16 23:00:00,4,4,22.51,97.14,41.45,27,192,219
2011-08-17 00:00:00,4,1,15.48,30.47,28.0,30,118,148
2011-08-17 01:00:00,4,3,30.3,68.39,14.76,35,4,39
2011-08-17 02:00:00,2,3,15.84,99.95,46.64,42,129,171
2011-08-17 03:00:00,3,4,12.81,31.08,31.2,48,45,93
2011-08-17 04:00:00,3,1,30.73,53.92,39.83,0,74,74
2011-08-17 05:00:00,4,3,16.24,82.43,0.16,8,125,133
2011-08-17 06:00:00,4,3,5.5,22.58,22.52,11,136,147
2011-08-17 07:00:00,2,1,16.71,75.18,43.55,22,135,157
2011-08-17 08:00:00,1,1,24.64,26.43,16.91,11,57,68
2011-08-17 09:00:00,1,2,12.63,38.92,36.33,41,102,143
2011-08-17 10:00:00,3,4,17.96,32.81,32.88,8,62,70
2011-08-17 11:00:00,2,4,6.7,92.59,7.61,25,188,213
2011-08-17 12:00:00,4,1,22.64,34.44,38.75,29,142,171
2011-08-17 13:00:00,3,4,27.69,23.23,5.63,19,72,91
2011-08-17 14:00:00,2,3,17.4,67.01,36.4,15,169,184
2011-08-17 15:00:00,1,1,17.61,47.69,49.55,12,177,189
2011-08-17 16:00:00,2,1,7.65,52.46,47.9,34,93,127
2011-08-17 17:00:00,1,1,11.06,29.53,40.01,49,178,227
2011-08-17 18:00:00,2,2,9.64,79.86,26.73,3,152,155
2011-08-17 19:00:00,3,4,19.45,68.12,33.74,24,149,173
2011-08-17 20:00:00,1,2,20.88,49.14,36.41,12,21,33
2011-08-17 21:00:00,3,3,33.47,33.73,0.42,27,93,120
2011-08-17 22:00:00,3,4,7.2,67.48,5.12,44,116,160
2011-08-17 23:00:00,1,2,23.0,82.29,29.85,11,73,84
2011-08-18 00:00:00,1,1,20.79,44.99,0.33,23,196,219
2011-08-18 01:00:00,4,2,20.49,22.07,45.45,27,196,223
2011-08-18 02:00:00,4,1,31.19,37.15,24.48,0,193,193
2011-08-18 03:00:00,4,2,11.17,74.59,12.89,33,63,96
2011-08-18 04:00:00,3,2,6.22,99.13,19.69,2,149,151
2011-08-18 05:00:00,3,2,25.17,21.07,42.54,21,140,161
2011-08-18 06:00:00,4,1,15.35,44.49,46.36,20,154,174
2011-08-18 07:00:00,3,2,5.53,24.96,5.81,26,46,72
2011-08-18 08:00:00,3,4,12.54,45.31,38.9,20,90,110
2011-08-18 09:00:00,1,4,14.28,52.47,28.91,21,20,41
2011-08-18 10:00:00,1,4,23.51,93.67,29.28,12,30,42
2011-08-18 11:00:00,3,1,10.18,26.44,38.97,43,120,163
2011-08-18 12:00:00,4,1,17.39,82.17,11.14,15,37,52
2011-08-18 13:00:00,2,4,19.47,51.64,26.55,45,38,83
2011-08-18 14:00:00,4,4,18.78,84.9,15.97,23,163,186
2011-08-18 15:00:00,2,4,34.22,61.07,4.73,45,99,144
2011-08-18 16:00:00,4,3,6.37,23.14,5.25,16,192,208
2011-08-18 17:00:00,1,4,33.53,95.7,6.82,4,10,14
2011-08-18 18:00:00,3,2,22.46,26.62,30.74,37,68,105
2011-08-18 19:00:00,3,3,28.87,67.81,5.29,41,33,74
2011-08-18 20:00:00,1,3,17.91,90.21,28.51,26,4,30
2011-08-18 21:00:00,2,1,18.62,26.38,29.41,40,19,59
2011-08-18 22:00:00,2,2,31.38,64.31,45.19,31,62,93
2011-08-18 23:00:00,2,1,31.88,85.94,31.32,25,44,69
2011-08-19 00:00:00,1,1,12.16,98.91,49.28,6,169,175
2011-08-19 01:00:00,2,2,10.98,77.95,1.55,35,12,47
2011-08-19 02:00:00,1,1,19.89,42.27,35.21,6,136,142
2011-08-19 03:00:00,4,2,32.01,75.97,1.32,42,132,174
2011-08-19 04:00:00,4,2,14.67,76.46,36.47,26,165,191
2011-08-19 05:00:00,1,1,24.56,76.0,19.29,37,93,130
2011-08-19 06:00:00,3,4,26.24,88.34,30.57,47,176,223
2011-08-19 07:00:00,4,1,28.36,26.99,15.48,47,91,138
2011-08-19 08:00:00,2,3,21.92,28.67,7.96,23,100,123
2011-08-19 09:00:00,1,1,17.07,71.25,36.18,23,155,178
2011-08-19 10:00:00,2,2,34.01,96.31,45.23,44,120,164
2011-08-19 11:00:00,2,3,23.34,57.27,9.18,43,123,166
2011-08-19 12:00:00,3,2,26.86,96.85,46.04,28,170,198
2011-08-19 13:00:00,2,4,15.35,95.05,7.01,26,197,223
2011-08-19 14:00:00,3,4,25.1,92.23,36.78,33,168,201
2011-08-19 15:00:00,4,3,12.73,92.79,47.97,20,171,191
2011-08-19 16:00:00,1,4,12.35,91.87,7.37,44,156,200
2011-08-19 17:00:00,2,4,26.44,85.59,21.75,0,67,67
2011-08-19 18:00:00,1,1,20.64,75.6,16.87,9,24,33
2011-08-19 19:00:00,2,1,25.5,21.95,19.42,29,195,224
2011-08-19 20:00:00,1,4,13.08,30.58,37.66,27,13,40
2011-08-19 21:00:00,2,4,22.96,30.74,33.06,41,186,227
2011-08-19 22:00:00,2,1,18.32,21.88,48.43,29,61,90
2011-08-19 23:00:00,2,4,22.91,29.34,9.27,27,144,171
2011-08-20 00:00:00,2,4,13.73,93.58,27.16,28,116,144
2011-08-20 01:00:00,2,2,26.46,73.1,22.46,30,146,176
2011-08-20 02:00:00,2,4,29.18,44.97,45.94,42,156,198
2011-08-20 03:00:00,2,3,12.8,83.47,0.53,40,99,139
2011-08-20 04:00:00,2,2,14.02,59.07,49.46,3,65,68
2011-08-20 05:00:00,2,3,24.83,31.37,23.99,48,44,92
2011-08-20 06:00:00,1,4,25.87,90.76,31.28,18,70,88
2011-08-20 07:00:00,3,1,26.12,47.09,18.0,9,27,36
2011-08-20 08:00:00,2,2,25.48,75.91,42.63,44,58,102
2011-08-20 09:00:00,3,1,16.78,43.25,28.1,30,181,211
2011-08-20 10:00:00,2,2,16.85,60.01,33.14,33,7,40
2011-08-20 11:00:00,2,1,12.64,85.3,32.45,40,9,49
2011-08-20 12:00:00,1,2,9.71,32.54,18.2,38,20,58
2011-08-20 13:00:00,4,2,25.78,98.18,3.8,41,34,75
2011-08-20 14:00:00,4,3,7.8,25.62,40.39,43,3,46
2011-08-20 15:00:00,1,1,33.13,62.72,14.49,30,180,210
2011-08-20 16:00:00,3,3,29.8,93.28,42.45,10,84,94
2011-08-20 17:00:00,4,3,30.73,95.66,30.43,35,24,59
2011-08-20 18:00:00,1,1,32.2,38.57,17.69,43,19,62
2011-08-20 19:00:00,1,2,17.26,31.52,29.71,43,198,241
2011-08-20 20:00:00,4,3,30.4,77.95,32.27,31,198,229
2011-08-20 21:00:00,3,1,9.74,23.36,35.33,22,95,117
2011-08-20 22:00:00,1,2,5.65,58.82,41.12,39,95,134
2011-08-20 23:00:00,2,3,28.55,83.71,7.99,45,126,171
2011-08-21 00:00:00,3,3,7.24,64.82,47.21,38,21,59
2011-08-21 01:00:00,3,3,34.66,35.04,20.54,2,48,50
2011-08-21 02:00:00,4,2,25.24,58.96,43.02,27,88,115
2011-08-21 03:00:00,4,3,27.6,93.7,11.02,24,5,29
2011-08-21 04:00:00,2,2,12.37,69.38,1.45,27,178,205
2011-08-21 05:00:00,1,4,25.22,77.72,28.67,18,154,172
2011-08-21 06:00:00,4,3,6.3,46.9,16.23,45,145,190
2011-08-21 07:00:00,4,4,30.13,35.08,49.22,18,11,29
2011-08-21 08:00:00,3,1,10.09,40.45,5.22,41,27,68
2011-08-21 09:00:00,4,3,25.92,62.65,2.37,43,18,61
2011-08-21 10:00:00,4,1,11.73,42.42,2.25,28,42,70
2011-08-21 11:00:00,4,1,7.05,63.36,10.84,49,98,147
2011-08-21 12:00:00,4,1,19.44,76.62,28.96,18,142,160
2011-08-21 13:00:00,3,4,10.08,78.75,25.28,17,196,213
2011-08-21 14:00:00,2,2,26.88,33.17,17.5,44,35,79
2011-08-21 15:00:00,2,4,12.13,80.03,4.44,48,96,144
2011-08-21 16:00:00,1,4,15.27,73.82,11.69,23,84,107
2011-08-21 17:00:00,4,1,22.02,20.96,9.21,37,41,78
2011-08-21 18:00:00,3,3,13.55,24.71,37.28,15,90,105
2011-08-21 19:00:00,1,2,16.34,71.7,39.0,17,125,142
2011-08-21 20:00:00,1,1,29.47,50.7,38.85,40,44,84
2011-08-21 21:00:00,2,2,10.38,31.69,48.45,12,29,41
2011-08-21 22:00:00,3,4,7.47,23.55,44.21,3,38,41
2011-08-21 23:00:00,3,2,14.85,32.75,24.89,12,173,185
2011-08-22 00:00:00,3,2,17.73,96.6,20.75,34,185,219
2011-08-22 01:00:00,2,3,21.28,78.21,45.79,3,29,32
2011-08-22 02:00:00,2,1,16.17,62.22,30.56,18,108,126
2011-08-22 03:00:00,2,2,28.7,95.32,14.72,23,183,206
2011-08-22 04:00:00,2,2,6.18,69.53,28.22,32,87,119
2011-08-22 05:00:00,2,4,17.95,78.05,49.61,32,181,213
2011-08-22 06:00:00,4,4,16.47,42.61,42.47,8,85,93
2011-08-22 07:00:00,4,2,24.43,67.12,14.06,2,36,38
2011-08-22 08:00:00,3,1,33.99,31.48,47.65,2,89,91
2011-08-22 09:00:00,1,2,20.31,52.36,49.07,29,149,178
2011-08-22 10:00:00,3,2,34.61,22.66,11.56,17,96,113
2011-08-22 11:00:00,1,3,14.07,37.33,44.78,1,23,24
2011-08-22 12:00:00,2,1,5.93,25.99,44.16,31,68,99
2011-08-22 13:00:00,1,3,9.97,51.02,1.99,42,87,129
2011-08-22 14:00:00,3,1,16.85,87.44,33.48,8,98,106
2011-08-22 15:00:00,3,1,14.49,50.23,15.26,1,121,122
2011-08-22 16:00:00,1,1,7.91,86.53,33.73,19,85,104
2011-08-22 17:00:00,4,3,17.98,72.52,45.68,26,160,186
2011-08-22 18:00:00,2,3,15.14,60.76,24.94,35,16,51
2011-08-22 19:00:00,2,3,8.68,38.95,20.72,40,189,229
2011-08-22 20:00:00,3,4,13.88,93.77,46.08,45,11,56
2011-08-22 21:00:00,4,3,31.59,24.34,48.71,18,29,47
2011-08-22 22:00:00,1,4,14.06,75.11,3.11,15,140,155
2011-08-22 23:00:00,2,4,26.42,69.7,46.14,25,5,30
2011-08-23 00:00:00,4,4,23.36,55.28,4.14,13,194,207
2011-08-23 01:00:00,2,2,17.82,39.23,16.86,46,124,170
2011-08-23 02:00:00,4,2,12.17,54.46,38.13,17,10,27
2011-08-23 03:00:00,4,2,16.07,89.82,38.85,27,127,154
2011-08-23 04:00:00,3,4,22.76,86.94,36.29,46,123,169
2011-08-23 05:00:00,2,4,15.52,95.31,1.96,18,59,77
2011-08-23 06:00:00,1,1,11.45,44.62,6.65,29,9,38
2011-08-23 07:00:00,3,4,8.49,50.97,46.81,40,15,55
2011-08-23 08:00:00,3,2,31.39,21.5,4.07,20,83,103
2011-08-23 09:00:00,1,4,18.21,95.44,3.93,20,169,189
2011-08-23 10:00:00,3,4,23.76,46.35,41.78,47,171,218
2011-08-23 11:00:00,4,1,19.71,52.33,32.06,29,146,175
2011-08-23 12:00:00,4,4,31.18,92.62,17.58,48,99,147
2011-08-23 13:00:00,2,3,21.41,62.13,8.29,41,14,55
2011-08-23 14:00:00,2,1,19.42,65.29,44.21,36,84,120
2011-08-23 15:00:00,1,4,32.74,34.1,49.43,40,38,78
2011-08-23 16:00:00,2,4,26.59,59.89,2.5,45,4,49
2011-08-23 17:00:00,4,1,8.35,93.46,27.71,31,85,116
2011-08-23 18:00:00,1,4,10.33,64.7,13.07,29,30,59
2011-08-23 19:00:00,1,2,28.61,40.41,41.62,21,155,176
2011-08-23 20:00:00,2,3,30.08,22.49,17.3,23,37,60
2011-08-23 21:00:00,4,3,21.36,46.9,35.73,9,179,188
2011-08-23 22:00:00,1,2,21.63,65.81,26.98,23,142,165
2011-08-23 23:00:00,4,4,23.96,23.41,27.08,0,18,18
2011-08-24 00:00:00,4,4,18.17,68.78,42.9,34,162,196
2011-08-24 01:00:00,4,3,25.41,61.87,23.52,15,14,29
2011-08-24 02:00:00,2,4,8.25,82.67,42.28,4,113,117
2011-08-24 03:00:00,3,3,33.84,22.31,18.17,30,87,117
2011-08-24 04:00:00,3,3,27.5,82.47,8.74,44,174,218
2011-08-24 05:00:00,1,2,23.94,61.67,22.77,36,183,219
2011-08-24 06:00:00,4,3,14.49,49.64,24.92,24,147,171
2011-08-24 07:00:00,2,4,9.83,97.23,23.92,42,8,50
2011-08-24 08:00:00,4,4,17.28,32.81,40.42,48,4,52
2011-08-24 09:00:00,4,1,24.85,63.31,28.23,24,138,162
2011-08-24 10:00:00,2,4,24.01,45.68,44.42,2,117,119
2011-08-24 11:00:00,3,1,16.48,62.2,25.71,37,102,139
2011-08-24 12:00:00,4,3,23.4,64.18,11.24,31,90,121
2011-08-24 13:00:00,4,4,29.41,27.16,6.47,47,1,48
2011-08-24 14:00:00,3,2,5.79,72.89,43.42,19,179,198
2011-08-24 15:00:00,2,2,18.52,70.76,2.81,29,147,176
2011-08-24 16:00:00,1,2,27.76,81.56,5.88,1,20,21
2011-08-24 17:00:00,3,3,21.38,27.25,3.18,4,50,54
2011-08-24 18:00:00,1,3,24.54,43.78,21.19,18,157,175
2011-08-24 19:00:00,1,1,20.5,72.01,26.63,19,175,194
2011-08-24 20:00:00,3,2,34.76,30.94,0.99,21,0,21
2011-08-24 21:00:00,4,1,6.64,74.21,25.78,10,162,172
2011-08-24 22:00:00,1,1,19.73,24.72,19.69,17,153,170
2011-08-24 23:00:00,1,4,7.74,46.79,38.68,26,8,34
2011-08-25 00:00:00,2,4,9.79,87.74,41.5,30,112,142
2011-08-25 01:00:00,4,2,16.49,81.94,34.25,34,167,201
2011-08-25 02:00:00,1,3,9.67,71.58,23.67,43,20,63
2011-08-25 03:00:00,2,4,33.91,89.64,10.81,44,79,123
2011-08-25 04:00:00,4,3,33.4,76.74,42.36,20,139,159
2011-08-25 05:00:00,3,1,15.08,61.55,17.08,19,36,55
2011-08-25 06:00:00,3,1,24.19,98.38,17.81,8,90,98
2011-08-25 07:00:00,2,1,21.01,75.59,45.8,30,70,100
2011-08-25 08:00:00,3,1,29.47,68.11,48.78,8,151,159
2011-08-25 09:00:00,1,2,23.82,52.71,44.91,6,177,183
2011-08-25 10:00:00,4,1,5.01,92.19,49.91,32,181,213
2011-08-25 11:00:00,1,4,27.9,43.66,43.45,0,109,109
2011-08-25 12:00:00,1,1,27.41,20.74,35.22,18,103,121
2011-08-25 13:00:00,3,3,20.29,35.74,14.69,2,108,110
2011-08-25 14:00:00,1,4,32.09,28.76,47.65,38,155,193
2011-08-25 15:00:00,3,3,32.25,45.52,43.83,11,3,14
2011-08-25 16:00:00,4,3,20.72,86.07,12.04,29,139,168
2011-08-25 17:00:00,4,2,23.24,72.12,24.46,15,66,81
2011-08-25 18:00:00,1,2,34.9,33.52,3.5,12,164,176
2011-08-25 19:00:00,2,3,13.96,83.11,47.67,49,3,52
2011-08-25 20:00:00,3,3,14.74,60.34,28.64,23,14,37
2011-08-25 21:00:00,3,1,10.48,61.02,12.26,16,155,171
2011-08-25 22:00:00,1,4,31.88,48.97,14.62,26,36,62
2011-08-25 23:00:00,3,1,27.33,89.17,49.03,28,136,164
2011-08-26 00:00:00,3,2,8.17,45.47,30.78,40,13,53
2011-08-26 01:00:00,2,2,34.45,27.53,21.03,13,122,135
2011-08-26 02:00:00,2,1,26.93,44.22,24.99,4,194,198
2011-08-26 03:00:00,1,4,30.52,77.23,4.93,42,110,152
2011-08-26 04:00:00,2,3,6.44,72.61,3.75,37,125,162
2011-08-26 05:00:00,1,1,20.15,35.04,29.64,5,81,86
2011-08-26 06:00:00,4,2,25.96,28.94,25.6,23,49,72
2011-08-26 07:00:00,1,4,21.29,72.87,17.96,39,77,116
2011-08-26 08:00:00,4,2,25.0,74.11,28.31,32,24,56
2011-08-26 09:00:00,1,4,29.54,49.29,3.63,8,38,46
2011-08-26 10:00:00,3,4,16.23,87.42,47.2,41,25,66
2011-08-26 11:00:00,2,4,30.46,98.26,14.69,48,59,107
2011-08-26 12:00:00,4,1,9.89,36.45,3.59,2,51,53
2011-08-26 13:00:00,1,1,13.13,66.17,8.48,22,69,91
2011-08-26 14:00:00,2,1,6.3,20.43,4.77,20,153,173
2011-08-26 15:00:00,1,4,15.93,77.04,8.93,21,47,68
2011-08-26 16:00:00,2,4,16.4,53.14,20.84,44,53,97
2011-08-26 17:00:00,2,2,29.16,35.46,36.9,7,114,121
2011-08-26 18:00:00,1,3,24.59,80.18,13.62,19,168,187
2011-08-26 19:00:00,4,1,18.1,84.85,21.8,13,115,128
2011-08-26 20:00:00,4,4,24.56,28.89,46.44,29,128,157
2011-08-26 21:00:00,3,2,6.58,23.28,14.79,7,113,120
2011-08-26 22:00:00,2,2,10.41,46.73,39.74,18,20,38
2011-08-26 23:00:00,3,2,23.81,70.08,7.89,44,109,153
2011-08-27 00:00:00,3,1,24.24,83.47,8.92,37,71,108
2011-08-27 01:00:00,1,1,28.22,63.68,22.81,35,152,187
2011-08-27 02:00:00,1,3,17.09,66.46,11.71,5,17,22
2011-08-27 03:00:00,1,2,26.68,83.99,45.15,33,14,47
2011-08-27 04:00:00,2,1,25.52,62.31,2.54,9,41,50
2011-08-27 05:00:00,1,2,33.9,68.89,29.86,30,19,49
2011-08-27 06:00:00,1,4,11.45,61.3,30.21,10,15,25
2011-08-27 07:00:00,2,2,21.55,90.44,3.3,42,134,176
2011-08-27 08:00:00,2,3,23.05,38.84,36.63,34,94,128
2011-08-27 09:00:00,4,1,34.96,41.12,23.44,10,92,102
2011-08-27 10:00:00,1,4,11.04,30.24,36.15,39,80,119
2011-08-27 11:00:00,1,1,20.7,85.56,41.35,31,132,163
2011-08-27 12:00:00,1,4,15.39,52.94,16.14,48,145,193
2011-08-27 13:00:00,4,2,20.78,47.83,24.22,25,77,102
2011-08-27 14:00:00,1,2,11.96,98.51,13.04,21,94,115
2011-08-27 15:00:00,4,3,6.43,94.14,10.08,0,145,145
2011-08-27 16:00:00,3,3,22.18,97.76,0.03,47,63,110
2011-08-27 17:00:00,4,4,15.08,31.38,48.18,28,152,180
2011-08-27 18:00:00,3,3,10.46,91.3,22.05,38,25,63
2011-08-27 19:00:00,1,3,14.72,46.3,0.65,21,196,217
2011-08-27 20:00:00,3,3,6.48,21.01,0.45,31,143,174
2011-08-27 21:00:00,4,3,33.51,51.3,14.42,24,190,214
2011-08-27 22:00:00,2,2,22.43,60.74,0.7,39,199,238
2011-08-27 23:00:00,3,3,29.44,28.66,18.73,44,76,120
2011-08-28 00:00:00,3,2,17.69,63.01,3.15,28,57,85
2011-08-28 01:00:00,1,2,32.1,85.56,1.96,36,95,131
2011-08-28 02:00:00,4,1,19.5,50.21,33.47,31,154,185
2011-08-28 03:00:00,3,2,22.22,48.21,45.34,29,176,205
2011-08-28 04:00:00,3,2,19.75,47.1,20.47,17,46,63
2011-08-28 05:00:00,3,3,27.0,93.85,41.84,43,70,113
2011-08-28 06:00:00,3,2,22.0,23.9,1.46,47,122,169
2011-08-28 07:00:00,2,4,13.15,55.61,38.88,2,177,179
2011-08-28 08:00:00,4,3,9.37,41.17,3.14,11,45,56
2011-08-28 09:00:00,1,3,23.18,91.5,41.92,19,7,26
2011-08-28 10:00:00,1,3,19.68,27.68,44.12,49,1,50
2011-08-28 11:00:00,2,1,7.88,52.92,39.3,7,145,152
2011-08-28 12:00:00,4,3,16.87,52.55,41.04,30,35,65
2011-08-28 13:00:00,3,2,20.44,91.07,28.07,23,87,110
2011-08-28 14:00:00,2,4,29.81,37.24,13.24,12,118,130
2011-08-28 15:00:00,4,3,7.28,71.59,32.16,7,41,48
2011-08-28 16:00:00,3,3,15.45,30.75,21.98,41,101,142
2011-08-28 17:00:00,2,4,29.68,96.32,0.27,13,138,151
2011-08-28 18:00:00,4,3,24.45,67.44,23.84,14,58,72
2011-08-28 19:00:00,1,1,13.7,70.1,32.56,20,179,199
2011-08-28 20:00:00,1,2,30.36,54.7,0.69,14,48,62
2011-08-28 21:00:00,4,4,19.8,47.38,31.07,25,183,208
2011-08-28 22:00:00,1,4,19.95,37.01,32.63,37,103,140
2011-08-28 23:00:00,4,1,34.3,68.32,7.91,45,197,242
2011-08-29 00:00:00,3,2,33.41,96.36,21.55,37,127,164
2011-08-29 01:00:00,4,1,15.76,48.78,48.22,32,73,105
2011-08-29 02:00:00,3,2,9.22,90.65,44.21,9,29,38
2011-08-29 03:00:00,2,1,14.77,31.9,20.54,18,182,200
2011-08-29 04:00:00,4,3,5.91,94.89,17.49,10,27,37
2011-08-29 05:00:00,2,1,5.62,48.04,6.2,2,92,94
2011-08-29 06:00:00,1,4,16.87,50.38,1.76,22,178,200
2011-08-29 07:00:00,3,4,33.23,57.03,14.87,5,26,31
2011-08-29 08:00:00,4,4,31.14,77.46,47.01,40,126,166
2011-08-29 09:00:00,2,1,20.34,77.57,47.93,40,97,137
2011-08-29 10:00:00,3,4,21.96,58.37,40.63,28,51,79
2011-08-29 11:00:00,3,4,5.18,61.85,17.54,3,161,164
2011-08-29 12:00:00,1,3,11.47,22.4,7.18,2,159,161
2011-08-29 13:00:00,1,3,5.74,44.34,29.78,19,43,62
2011-08-29 14:00:00,3,2,27.64,47.68,32.33,42,131,173
2011-08-29 15:00:00,3,2,9.37,64.7,21.23,48,47,95
2011-08-29 16:00:00,4,2,31.07,64.66,34.58,7,97,104
2011-08-29 17:00:00,3,1,24.3,76.79,37.33,5,15,20
2011-08-29 18:00:00,4,2,11.88,77.36,39.15,4,187,191
2011-08-29 19:00:00,3,1,9.73,38.82,25.11,7,46,53
2011-08-29 20:00:00,1,1,23.83,81.61,39.58,7,109,116
2011-08-29 21:00:00,4,2,32.03,21.57,1.27,34,74,108
2011-08-29 22:00:00,2,2,26.55,77.29,34.02,18,14,32
2011-08-29 23:00:00,1,1,15.46,28.16,11.78,47,101,148
2011-08-30 00:00:00,4,3,22.62,78.37,13.53,9,93,102
2011-08-30 01:00:00,4,4,14.32,62.17,4.57,34,183,217
2011-08-30 02:00:00,2,4,34.97,54.98,9.62,8,143,151
2011-08-30 03:00:00,4,4,27.47,75.25,49.6,7,128,135
2011-08-30 04:00:00,3,3,23.43,22.91,20.77,7,152,159
2011-08-30 05:00:00,2,1,17.7,37.88,46.39,7,63,70
2011-08-30 06:00:00,1,2,23.54,69.32,8.14,19,91,110
2011-08-30 07:00:00,1,1,15.25,87.78,10.2,6,42,48
2011-08-30 08:00:00,3,1,5.87,50.49,27.89,45,13,58
2011-08-30 09:00:00,1,2,16.85,40.7,17.48,21,175,196
2011-08-30 10:00:00,4,3,32.91,61.5,32.2,16,67,83
2011-08-30 11:00:00,4,4,23.79,69.79,21.1,43,13,56
2011-08-30 12:00:00,3,4,7.52,53.61,40.58,4,142,146
2011-08-30 13:00:00,1,1,31.55,90.14,21.58,33,144,177
2011-08-30 14:00:00,1,3,13.07,61.88,28.62,24,91,115
2011-08-30 15:00:00,3,4,12.31,22.87,16.05,46,179,225
2011-08-30 16:00:00,2,3,13.91,37.84,35.2,42,137,179
2011-08-30 17:00:00,1,2,22.32,56.05,32.74,14,16,30
2011-08-30 18:00:00,2,1,21.34,75.82,19.85,30,135,165
2011-08-30 19:00:00,1,1,19.74,37.58,13.8,44,1,45
2011-08-30 20:00:00,1,3,26.53,98.1,30.71,18,183,201
2011-08-30 21:00:00,1,4,14.5,45.48,47.16,43,64,107
2011-08-30 22:00:00,1,3,28.46,62.6,6.63,30,182,212
2011-08-30 23:00:00,4,2,10.26,21.52,39.96,46,118,164
2011-08-31 00:00:00,2,4,28.48,90.79,27.15,11,196,207
2011-08-31 01:00:00,2,4,24.91,83.11,26.28,22,98,120
2011-08-31 02:00:00,1,3,25.5,35.64,48.08,49,106,155
2011-08-31 03:00:00,1,2,19.45,94.66,30.29,22,116,138
2011-08-31 04:00:00,2,4,25.01,45.27,41.53,35,163,198
2011-08-31 05:00:00,4,1,7.39,75.37,25.72,10,8,18
2011-08-31 06:00:00,3,2,30.55,85.52,12.49,21,141,162
2011-08-31 07:00:00,3,4,6.67,79.27,34.72,46,73,119
2011-08-31 08:00:00,2,3,9.46,93.41,46.16,29,21,50
2011-08-31 09:00:00,1,4,22.3,89.14,42.06,4,15,19
2011-08-31 10:00:00,1,1,27.18,99.57,9.92,36,168,204
2011-08-31 11:00:00,4,2,7.29,34.61,15.84,19,194,213
2011-08-31 12:00:00,3,4,32.62,44.38,25.84,9,155,164
2011-08-31 13:00:00,4,1,34.21,70.9,28.58,21,93,114
2011-08-31 14:00:00,3,4,23.18,78.64,9.69,41,156,197
2011-08-31 15:00:00,2,4,19.44,62.77,11.5,29,192,221
2011-08-31 16:00:00,3,2,27.24,25.91,37.94,29,155,184
2011-08-31 17:00:00,4,3,14.85,87.33,36.52,21,85,106
2011-08-31 18:00:00,4,3,19.8,96.87,41.96,37,31,68
2011-08-31 19:00:00,4,1,32.48,52.44,46.65,37,179,216
2011-08-31 20:00:00,2,1,33.67,37.98,15.41,37,10,47
2011-08-31 21:00:00,3,1,32.81,21.55,42.98,6,153,159
2011-08-31 22:00:00,3,2,12.87,38.98,33.3,49,158,207
2011-08-31 23:00:00,4,3,11.97,75.99,47.89,35,19,54
2011-09-01 00:00:00,3,1,13.93,92.93,13.6,13,83,96
2011-09-01 01:00:00,1,1,18.24,27.48,13.48,10,196,206
2011-09-01 02:00:00,1,4,14.43,64.26,35.21,6,168,174
2011-09-01 03:00:00,1,4,16.23,75.64,46.42,31,66,97
2011-09-01 04:00:00,3,1,23.62,42.11,41.23,17,43,60
2011-09-01 05:00:00,2,4,27.88,65.59,36.35,33,187,220
2011-09-01 06:00:00,2,4,27.07,77.22,19.37,1,94,95
2011-09-01 07:00:00,2,4,29.43,87.02,35.89,6,105,111
2011-09-01 08:00:00,2,2,5.97,56.2,40.05,42,134,176
2011-09-01 09:00:00,1,1,6.43,79.83,37.66,30,93,123
2011-09-01 10:00:00,1,1,28.68,44.14,33.84,17,53,70
2011-09-01 11:00:00,4,4,20.99,37.04,2.36,19,190,209
2011-09-01 12:00:00,3,2,22.34,34.99,32.99,6,81,87
2011-09-01 13:00:00,3,4,6.58,48.71,23.91,21,12,33
2011-09-01 14:00:00,2,2,12.66,22.87,48.08,36,32,68
2011-09-01 15:00:00,1,1,24.15,42.64,30.36,33,134,167
2011-09-01 16:00:00,2,4,30.78,72.18,30.41,45,157,202
2011-09-01 17:00:00,4,1,32.51,71.83,49.7,38,10,48
2011-09-01 18:00:00,3,2,20.01,25.88,4.68,41,69,110
2011-09-01 19:00:00,3,3,21.36,42.99,13.82,49,20,69
2011-09-01 20:00:00,2,2,29.99,65.56,32.8,39,31,70
2011-09-01 21:00:00,4,3,21.13,45.48,15.76,15,132,147
2011-09-01 22:00:00,3,1,20.51,53.44,17.31,13,105,118
2011-09-01 23:00:00,4,1,32.15,77.02,44.63,40,92,132
2011-09-02 00:00:00,4,4,28.7,20.74,28.97,31,34,65
2011-09-02 01:00:00,2,3,32.27,42.11,5.14,37,46,83
2011-09-02 02:00:00,1,2,11.55,31.39,15.54,38,11,49
2011-09-02 03:00:00,2,1,20.73,30.21,3.8,25,36,61
2011-09-02 04:00:00,1,3,30.27,96.72,27.81,29,43,72
2011-09-02 05:00:00,4,2,8.33,50.12,8.66,40,21,61
2011-09-02 06:00:00,1,3,28.84,62.17,42.86,38,138,176
2011-09-02 07:00:00,4,2,10.49,78.71,28.87,8,86,94
2011-09-02 08:00:00,3,2,29.24,23.8,2.97,31,54,85
2011-09-02 09:00:00,3,2,23.36,39.28,15.04,6,9,15
2011-09-02 10:00:00,3,2,10.8,86.57,30.82,11,169,180
2011-09-02 11:00:00,2,3,19.2,88.96,16.77,22,116,138
2011-09-02 12:00:00,2,3,25.46,49.84,25.66,16,79,95
2011-09-02 13:00:00,4,4,24.02,49.99,45.47,20,75,95
2011-09-02 14:00:00,3,3,17.82,80.55,17.5,11,182,193
2011-09-02 15:00:00,2,3,31.98,43.61,16.79,21,177,198
2011-09-02 16:00:00,3,4,20.58,29.37,40.99,22,159,181
2011-09-02 17:00:00,2,3,20.18,40.6,15.94,4,87,91
2011-09-02 18:00:00,1,2,6.87,50.99,3.9,17,195,212
2011-09-02 19:00:00,1,1,32.66,24.18,9.05,36,96,132
2011-09-02 20:00:00,3,1,10.31,58.29,47.44,36,17,53
2011-09-02 21:00:00,4,4,20.85,79.2,46.66,6,110,116
2011-09-02 22:00:00,2,3,29.11,61.1,11.24,2,84,86
2011-09-02 23:00:00,2,3,11.46,25.75,27.68,0,64,64
2011-09-03 00:00:00,1,4,20.82,55.21,6.87,5,122,127
2011-09-03 01:00:00,1,1,12.22,76.71,33.73,6,107,113
2011-09-03 02:00:00,4,2,27.79,24.65,9.27,26,152,178
2011-09-03 03:00:00,4,3,21.93,24.79,2.49,30,122,152
2011-09-03 04:00:00,4,4,30.68,49.65,41.24,7,30,37
2011-09-03 05:00:00,3,2,31.84,35.6,16.27,13,146,159
2011-09-03 06:00:00,1,4,24.46,94.78,5.43,14,88,102
2011-09-03 07:00:00,3,4,26.76,66.51,41.7,6,112,118
2011-09-03 08:00:00,1,4,21.48,42.99,38.12,6,17,23
2011-09-03 09:00:00,1,1,16.53,76.38,34.19,32,195,227
2011-09-03 10:00:00,2,1,24.44,49.99,45.56,40,160,200
2011-09-03 11:00:00,1,4,32.25,30.57,24.46,6,69,75
2011-09-03 12:00:00,1,3,17.5,38.98,6.4,19,6,25
2011-09-03 13:00:00,3,2,14.43,71.42,3.07,6,0,6
2011-09-03 14:00:00,1,3,16.65,24.15,15.92,49,101,150
2011-09-03 15:00:00,3,1,18.06,41.82,4.34,13,98,111
2011-09-03 16:00:00,4,2,7.21,36.66,26.78,14,86,100
2011-09-03 17:00:00,1,4,19.95,36.09,0.72,17,79,96
2011-09-03 18:00:00,1,3,19.83,74.62,22.19,9,58,67
2011-09-03 19:00:00,3,3,22.65,86.07,8.92,34,33,67
2011-09-03 20:00:00,4,4,15.88,77.27,18.41,26,179,205
2011-09-03 21:00:00,2,3,23.39,71.66,33.75,42,138,180
2011-09-03 22:00:00,4,1,31.35,93.32,17.55,0,7,7
2011-09-03 23:00:00,3,4,33.66,24.67,17.07,27,87,114
2011-09-04 00:00:00,4,3,22.51,33.4,49.54,33,52,85
2011-09-04 01:00:00,3,4,6.28,53.15,35.94,47,142,189
2011-09-04 02:00:00,3,2,34.08,49.8,25.69,2,27,29
2011-09-04 03:00:00,2,4,26.18,53.44,28.97,48,141,189
2011-09-04 04:00:00,1,3,15.08,36.52,31.01,2,89,91
2011-09-04 05:00:00,3,1,9.41,31.96,1.23,10,185,195
2011-09-04 06:00:00,3,4,9.3,60.74,4.01,3,56,59
2011-09-04 07:00:00,2,4,10.03,94.24,32.46,29,179,208
2011-09-04 08:00:00,3,3,6.37,51.36,18.22,38,36,74
2011-09-04 09:00:00,1,1,32.06,23.47,2.77,31,1,32
2011-09-04 10:00:00,2,1,21.22,76.49,14.88,15,161,176
2011-09-04 11:00:00,1,2,26.0,43.29,6.51,16,33,49
2011-09-04 12:00:00,1,2,29.84,39.61,45.82,10,57,67
2011-09-04 13:00:00,2,3,28.75,45.94,10.15,35,72,107
2011-09-04 14:00:00,3,1,31.48,77.91,7.18,31,188,219
2011-09-04 15:00:00,1,1,34.02,85.51,31.31,34,107,141
2011-09-04 16:00:00,1,2,18.17,67.04,26.1,26,116,142
2011-09-04 17:00:00,1,2,33.51,45.8,28.8,47,181,228
2011-09-04 18:00:00,1,3,26.7,44.84,21.8,33,115,148
2011-09-04 19:00:00,2,1,7.12,29.94,23.36,4,113,117
2011-09-04 20:00:00,2,4,25.45,94.66,38.94,24,194,218
2011-09-04 21:00:00,4,2,25.6,71.05,11.0,27,29,56
2011-09-04 22:00:00,4,3,32.18,22.16,19.83,17,82,99
2011-09-04 23:00:00,1,1,16.19,72.99,47.89,2,106,108
2011-09-05 00:00:00,3,1,22.55,55.77,9.5,27,58,85
2011-09-05 01:00:00,1,2,5.37,97.8,14.69,1,185,186
2011-09-05 02:00:00,3,3,14.96,85.53,9.58,33,119,152
2011-09-05 03:00:00,1,4,6.87,33.71,1.02,21,151,172
2011-09-05 04:00:00,4,2,20.66,77.61,13.49,21,142,163
2011-09-05 05:00:00,4,3,29.52,58.85,2.32,29,149,178
2011-09-05 06:00:00,3,1,11.19,34.96,7.73,33,159,192
2011-09-05 07:00:00,1,4,20.82,75.9,18.13,47,74,121
2011-09-05 08:00:00,3,3,11.12,63.79,1.04,0,92,92
2011-09-05 09:00:00,4,4,8.62,22.43,37.65,28,169,197
2011-09-05 10:00:00,1,3,20.33,71.73,39.78,18,186,204
2011-09-05 11:00:00,1,3,7.37,70.8,20.57,18,87,105
2011-09-05 12:00:00,3,3,22.62,31.53,49.23,40,82,122
2011-09-05 13:00:00,2,3,5.94,47.92,33.95,40,54,94
2011-09-05 14:00:00,3,4,8.2,66.87,37.19,28,132,160
2011-09-05 15:00:00,4,2,21.5,31.1,9.62,42,168,210
2011-09-05 16:00:00,4,4,22.74,88.22,41.87,32,56,88
2011-09-05 17:00:00,4,3,5.87,22.2,47.25,16,52,68
2011-09-05 18:00:00,4,4,22.2,28.23,11.82,37,165,202
2011-09-05 19:00:00,4,4,30.16,29.29,34.32,0,0,0
2011-09-05 20:00:00,2,4,26.67,62.25,37.35,49,59,108
2011-09-05 21:00:00,1,3,8.94,69.61,15.26,40,75,115
2011-09-05 22:00:00,3,4,22.77,52.3,23.75,32,45,77
2011-09-05 23:00:00,3,1,25.17,43.09,4.88,35,3,38
2011-09-06 00:00:00,4,3,6.12,84.75,8.65,21,14,35
2011-09-06 01:00:00,3,4,30.66,25.46,3.08,17,80,97
2011-09-06 02:00:00,4,1,32.19,42.42,28.01,16,115,131
2011-09-06 03:00:00,2,4,30.51,23.13,31.26,31,11,42
2011-09-06 04:00:00,2,2,29.74,21.11,45.81,19,0,19
2011-09-06 05:00:00,1,4,27.35,48.27,27.11,22,76,98
2011-09-06 06:00:00,2,4,24.0,35.59,13.03,27,29,56
2011-09-06 07:00:00,2,2,25.36,41.47,2.97,45,133,178
2011-09-06 08:00:00,1,3,29.19,85.68,44.25,25,72,97
2011-09-06 09:00:00,3,2,24.87,33.04,23.94,6,49,55
2011-09-06 10:00:00,4,3,14.83,82.42,36.87,40,129,169
2011-09-06 11:00:00,4,2,16.28,74.0,0.73,19,5,24
2011-09-06 12:00:00,3,4,31.91,46.12,24.41,40,74,114
2011-09-06 13:00:00,1,4,5.51,63.72,16.29,46,89,135
2011-09-06 14:00:00,3,3,25.96,55.55,1.52,10,91,101
2011-09-06 15:00:00,2,3,33.64,30.27,38.78,6,76,82
2011-09-06 16:00:00,1,1,26.19,92.57,25.65,37,165,202
2011-09-06 17:00:00,1,1,34.82,65.57,16.66,26,75,101
2011-09-06 18:00:00,1,4,25.63,90.42,40.29,8,82,90
2011-09-06 19:00:00,4,4,6.03,85.91,22.35,3,17,20
2011-09-06 20:00:00,3,1,29.81,26.38,0.17,48,146,194
2011-09-06 21:00:00,1,1,13.54,36.58,47.22,37,155,192
2011-09-06 22:00:00,1,3,18.38,31.62,12.78,28,11,39
2011-09-06 23:00:00,1,2,14.36,86.46,41.53,48,51,99
2011-09-07 00:00:00,3,3,13.06,89.0,40.82,25,86,111
2011-09-07 01:00:00,4,1,17.94,62.24,8.12,24,99,123
2011-09-07 02:00:00,2,4,16.36,28.33,23.7,13,185,198
2011-09-07 03:00:00,4,1,24.0,30.85,2.01,36,21,57
2011-09-07 04:00:00,1,4,29.39,85.08,17.73,49,101,150
2011-09-07 05:00:00,4,4,13.91,94.34,36.55,27,172,199
2011-09-07 06:00:00,4,4,11.41,35.96,11.85,7,61,68
2011-09-07 07:00:00,2,4,25.01,20.89,5.86,41,41,82
2011-09-07 08:00:00,3,2,25.11,46.48,25.36,10,66,76
2011-09-07 09:00:00,3,1,32.03,22.44,26.85,34,136,170
2011-09-07 10:00:00,4,3,5.48,86.24,33.79,30,191,221
2011-09-07 11:00:00,4,4,30.59,59.32,37.96,33,142,175
2011-09-07 12:00:00,3,4,20.63,71.35,34.79,45,157,202
2011-09-07 13:00:00,3,3,23.64,52.92,42.27,35,153,188
2011-09-07 14:00:00,2,3,7.74,47.64,11.15,16,93,109
2011-09-07 15:00:00,1,4,17.98,37.78,28.49,48,196,244
2011-09-07 16:00:00,4,3,11.82,81.64,18.0,20,121,141
2011-09-07 17:00:00,3,3,12.63,75.64,48.11,25,94,119
2011-09-07 18:00:00,4,2,20.12,48.86,22.01,40,126,166
2011-09-07 19:00:00,4,3,29.37,45.69,47.99,27,21,48
2011-09-07 20:00:00,3,1,27.31,20.1,38.45,21,53,74
2011-09-07 21:00:00,2,1,22.73,25.08,35.92,40,124,164
2011-09-07 22:00:00,4,1,21.18,69.86,24.58,2,57,59
2011-09-07 23:00:00,2,4,17.82,61.17,22.17,27,180,207
2011-09-08 00:00:00,3,1,34.18,54.78,26.33,35,98,133
2011-09-08 01:00:00,1,2,21.81,86.2,14.68,1,18,19
2011-09-08 02:00:00,1,1,12.62,60.31,45.23,45,161,206
2011-09-08 03:00:00,4,4,11.9,50.76,39.72,19,141,160
2011-09-08 04:00:00,3,2,23.34,32.9,40.07,39,21,60
2011-09-08 05:00:00,2,1,20.68,85.66,21.66,49,140,189
2011-09-08 06:00:00,4,2,5.23,66.1,3.55,35,122,157
2011-09-08 07:00:00,3,2,29.9,27.4,34.15,7,191,198
2011-09-08 08:00:00,3,4,26.12,71.91,18.72,38,55,93
2011-09-08 09:00:00,2,4,24.85,54.01,43.52,24,199,223
2011-09-08 10:00:00,4,2,7.06,84.91,39.02,14,41,55
2011-09-08 11:00:00,3,1,15.86,93.51,7.27,29,65,94
2011-09-08 12:00:00,3,4,33.06,68.04,30.09,46,190,236
2011-09-08 13:00:00,3,2,30.88,78.53,34.61,33,169,202
2011-09-08 14:00:00,2,3,13.57,24.53,28.41,3,33,36
2011-09-08 15:00:00,4,3,9.71,64.82,25.7,21,28,49
2011-09-08 16:00:00,4,4,18.47,80.43,11.39,24,153,177
2011-09-08 17:00:00,4,1,15.67,59.74,11.8,8,150,158
2011-09-08 18:00:00,4,3,25.47,67.48,38.4,22,35,57
2011-09-08 19:00:00,1,3,33.99,91.92,0.93,38,117,155
2011-09-08 20:00:00,1,3,15.89,35.85,38.95,49,8,57
2011-09-08 21:00:00,4,1,6.87,27.86,26.34,11,84,95
2011-09-08 22:00:00,2,1,31.93,75.25,46.81,13,41,54
2011-09-08 23:00:00,1,4,6.14,85.83,49.87,6,66,72
2011-09-09 00:00:00,3,4,33.58,88.04,33.17,30,6,36
2011-09-09 01:00:00,1,3,24.94,71.33,20.61,5,22,27
2011-09-09 02:00:00,3,1,33.25,86.66,23.75,22,159,181
2011-09-09 03:00:00,4,2,10.99,76.05,10.21,18,22,40
2011-09-09 04:00:00,1,3,6.22,26.99,4.96,20,15,35
2011-09-09 05:00:00,2,4,19.65,80.96,28.94,18,68,86
2011-09-09 06:00:00,1,1,18.52,34.35,40.27,46,12,58
2011-09-09 07:00:00,1,4,14.94,38.93,13.09,18,9,27
2011-09-09 08:00:00,1,4,33.73,51.57,20.98,43,58,101
2011-09-09 09:00:00,4,1,29.68,45.17,27.74,33,1,34
2011-09-09 10:00:00,2,3,24.85,45.73,45.39,42,179,221
2011-09-09 11:00:00,1,1,9.89,33.54,6.93,12,128,140
2011-09-09 12:00:00,2,3,27.03,43.51,11.84,35,197,232
2011-09-09 13:00:00,4,4,26.81,21.57,45.93,24,53,77
2011-09-09 14:00:00,3,1,17.75,57.83,1.98,32,18,50
2011-09-09 15:00:00,1,2,32.74,81.49,32.81,20,96,116
2011-09-09 16:00:00,2,3,10.01,88.98,31.98,33,27,60
2011-09-09 17:00:00,2,2,13.02,85.63,19.16,45,132,177
2011-09-09 18:00:00,4,3,6.9,53.32,23.41,24,75,99
2011-09-09 19:00:00,1,1,28.86,78.43,42.75,17,157,174
2011-09-09 20:00:00,3,2,23.65,43.03,8.25,42,18,60
2011-09-09 21:00:00,2,1,14.45,24.44,11.58,10,103,113
2011-09-09 22:00:00,1,3,9.91,74.08,25.62,18,41,59
2011-09-09 23:00:00,3,3,6.2,71.9,20.49,48,152,200
2011-09-10 00:00:00,2,3,10.0,84.13,28.72,48,34,82
2011-09-10 01:00:00,2,3,18.6,69.29,46.04,33,8,41
2011-09-10 02:00:00,3,4,12.42,32.55,45.86,1,38,39
2011-09-10 03:00:00,3,3,12.77,88.25,11.5,29,183,212
2011-09-10 04:00:00,4,2,31.27,70.18,15.11,44,37,81
2011-09-10 05:00:00,1,3,20.45,84.61,8.1,37,14,51
2011-09-10 06:00:00,1,1,26.88,81.93,46.39,14,108,122
2011-09-10 07:00:00,4,4,6.07,43.83,19.89,10,173,183
2011-09-10 08:00:00,2,2,15.95,25.96,22.49,23,164,187
2011-09-10 09:00:00,3,4,19.38,34.12,40.13,3,89,92
2011-09-10 10:00:00,3,4,10.59,27.43,25.65,18,124,142
2011-09-10 11:00:00,3,4,8.61,39.47,5.99,28,59,87
2011-09-10 12:00:00,2,1,31.11,56.76,21.89,13,61,74
2011-09-10 13:00:00,3,4,33.18,92.54,31.53,49,30,79
2011-09-10 14:00:00,3,4,7.36,89.76,35.96,16,29,45
2011-09-10 15:00:00,4,3,15.47,77.49,32.27,7,65,72
2011-09-10 16:00:00,2,1,33.75,21.93,5.96,12,6,18
2011-09-10 17:00:00,1,2,7.49,47.31,15.22,22,157,179
2011-09-10 18:00:00,4,2,24.31,74.59,36.68,28,160,188
2011-09-10 19:00:00,4,2,34.17,30.32,44.01,46,111,157
2011-09-10 20:00:00,1,1,34.35,84.09,2.36,10,102,112
2011-09-10 21:00:00,4,2,19.14,93.17,2.11,15,110,125
2011-09-10 22:00:00,2,1,9.88,48.33,32.17,49,37,86
2011-09-10 23:00:00,3,3,11.06,76.47,27.4,43,146,189
2011-09-11 00:00:00,2,3,31.69,31.86,7.77,22,136,158
2011-09-11 01:00:00,1,1,32.35,75.27,27.41,11,85,96
2011-09-11 02:00:00,1,2,23.24,21.72,48.72,37,159,196
2011-09-11 03:00:00,4,1,27.99,32.06,31.55,23,157,180
2011-09-11 04:00:00,2,1,27.2,76.79,22.46,30,133,163
2011-09-11 05:00:00,2,4,24.85,76.95,41.38,37,188,225
2011-09-11 06:00:00,1,1,29.82,71.29,10.64,35,164,199
2011-09-11 07:00:00,2,4,25.56,58.19,20.72,0,78,78
2011-09-11 08:00:00,1,3,21.02,73.99,26.39,25,198,223
2011-09-11 09:00:00,2,4,12.11,81.9,25.23,16,147,163
2011-09-11 10:00:00,2,1,27.32,97.32,46.05,35,29,64
2011-09-11 11:00:00,2,3,19.2,91.09,14.63,16,17,33
2011-09-11 12:00:00,1,4,13.84,83.56,2.83,36,190,226
2011-09-11 13:00:00,4,1,29.06,75.58,45.82,26,188,214
2011-09-11 14:00:00,2,3,25.9,65.93,10.85,24,184,208
2011-09-11 15:00:00,1,4,33.12,29.65,18.95,29,149,178
2011-09-11 16:00:00,1,1,9.96,33.24,26.54,40,87,127
2011-09-11 17:00:00,2,1,24.48,85.62,48.79,24,94,118
2011-09-11 18:00:00,2,2,12.33,84.27,26.76,37,176,213
2011-09-11 19:00:00,4,2,32.11,69.16,22.39,31,17,48
2011-09-11 20:00:00,1,4,7.98,55.11,29.18,11,60,71
2011-09-11 21:00:00,1,4,24.68,22.08,48.54,48,81,129
2011-09-11 22:00:00,3,4,28.73,46.17,40.9,20,77,97
2011-09-11 23:00:00,1,1,15.65,53.65,8.45,41,195,236
2011-09-12 00:00:00,4,4,33.62,58.87,40.16,33,134,167
2011-09-12 01:00:00,3,1,30.52,94.35,42.05,0,134,134
2011-09-12 02:00:00,3,4,13.84,28.7,34.53,12,64,76
2011-09-12 03:00:00,3,1,5.23,61.51,32.86,20,39,59
2011-09-12 04:00:00,2,1,13.9,49.43,22.04,0,115,115
2011-09-12 05:00:00,2,2,13.44,99.21,32.08,12,23,35
2011-09-12 06:00:00,1,3,31.7,88.95,36.88,30,159,189
2011-09-12 07:00:00,3,1,34.01,55.1,6.14,22,9,31
2011-09-12 08:00:00,4,4,7.11,99.98,12.87,2,136,138
2011-09-12 09:00:00,2,2,19.14,61.13,9.7,10,38,48
2011-09-12 10:00:00,4,4,21.45,33.37,42.06,28,130,158
2011-09-12 11:00:00,4,4,7.79,64.47,34.0,47,107,154
2011-09-12 12:00:00,2,1,16.32,38.1,22.54,17,68,85
2011-09-12 13:00:00,2,1,14.51,70.91,41.3,24,6,30
2011-09-12 14:00:00,2,3,21.08,95.0,35.84,33,139,172
2011-09-12 15:00:00,2,1,24.84,82.9,45.68,17,22,39
2011-09-12 16:00:00,3,1,26.1,41.85,3.84,48,88,136
2011-09-12 17:00:00,3,3,9.1,43.75,25.46,0,190,190
2011-09-12 18:00:00,3,4,29.39,25.54,35.34,27,16,43
2011-09-12 19:00:00,3,3,25.36,42.87,10.37,3,77,80
2011-09-12 20:00:00,1,3,31.67,27.41,16.36,20,191,211
2011-09-12 21:00:00,3,3,18.48,59.96,20.95,5,64,69
2011-09-12 22:00:00,2,2,31.82,76.67,39.72,20,85,105
2011-09-12 23:00:00,4,4,30.97,80.09,24.68,36,27,63
2011-09-13 00:00:00,3,2,18.15,24.76,24.64,29,57,86
2011-09-13 01:00:00,1,2,16.43,47.2,21.54,19,17,36
2011-09-13 02:00:00,2,1,32.98,43.05,11.43,40,109,149
2011-09-13 03:00:00,4,3,26.45,28.34,46.15,31,120,151
2011-09-13 04:00:00,4,3,32.85,49.0,15.89,30,43,73
2011-09-13 05:00:00,3,2,28.91,43.95,28.37,35,63,98
2011-09-13 06:00:00,4,1,23.28,70.76,7.44,24,36,60
2011-09-13 07:00:00,3,1,8.48,90.66,21.71,4,2,6
2011-09-13 08:00:00,3,1,13.74,56.39,45.19,7,13,20
2011-09-13 09:00:00,2,4,34.07,79.73,49.77,16,134,150
2011-09-13 10:00:00,2,2,14.58,31.68,18.09,14,144,158
2011-09-13 11:00:00,1,4,7.8,91.6,7.7,19,197,216
2011-09-13 12:00:00,2,1,26.23,32.21,15.72,44,82,126
2011-09-13 13:00:00,2,1,27.02,35.37,16.36,46,166,212
2011-09-13 14:00:00,3,1,13.56,28.52,32.23,28,132,160
2011-09-13 15:00:00,2,3,13.93,44.77,24.81,35,78,113
2011-09-13 16:00:00,3,2,19.07,64.19,38.42,49,51,100
2011-09-13 17:00:00,3,3,5.65,99.04,35.07,27,108,135
2011-09-13 18:00:00,2,4,28.68,83.47,12.57,7,25,32
2011-09-13 19:00:00,1,3,14.51,50.43,39.21,13,166,179
2011-09-13 20:00:00,1,2,30.61,66.07,42.37,32,172,204
2011-09-13 21:00:00,4,3,29.08,69.86,29.92,33,76,109
2011-09-13 22:00:00,4,1,24.84,85.82,46.38,28,30,58
2011-09-13 23:00:00,2,4,14.75,78.92,39.15,21,150,171
2011-09-14 00:00:00,1,4,20.49,65.54,29.77,2,39,41
2011-09-14 01:00:00,3,1,18.34,73.53,45.31,47,31,78
2011-09-14 02:00:00,4,1,15.17,79.67,30.02,22,100,122
2011-09-14 03:00:00,3,1,30.44,30.65,26.06,2,3,5
2011-09-14 04:00:00,4,2,19.51,36.04,17.81,5,80,85
2011-09-14 05:00:00,2,3,29.98,75.09,44.14,39,83,122
2011-09-14 06:00:00,1,4,8.16,88.03,6.14,22,173,195
2011-09-14 07:00:00,4,3,9.23,52.74,23.68,11,74,85
2011-09-14 08:00:00,1,1,34.32,98.39,26.87,4,41,45
2011-09-14 09:00:00,3,1,22.63,37.29,27.74,4,96,100
2011-09-14 10:00:00,2,3,20.29,53.34,32.59,2,166,168
2011-09-14 11:00:00,1,4,20.69,50.28,25.29,3,197,200
2011-09-14 12:00:00,2,2,11.46,94.42,12.84,23,102,125
2011-09-14 13:00:00,1,3,26.56,42.83,42.85,4,183,187
2011-09-14 14:00:00,3,1,7.54,57.66,32.88,30,46,76
2011-09-14 15:00:00,3,1,22.2,34.98,42.91,34,165,199
2011-09-14 16:00:00,2,2,22.12,61.7,13.8,41,17,58
2011-09-14 17:00:00,3,3,32.43,88.59,31.85,18,1,19
2011-09-14 18:00:00,4,2,20.79,44.32,35.71,7,104,111
2011-09-14 19:00:00,1,2,9.11,84.86,19.17,27,101,128
2011-09-14 20:00:00,3,4,22.18,92.9,40.61,37,181,218
2011-09-14 21:00:00,4,4,7.74,25.84,0.13,22,87,109
2011-09-14 22:00:00,2,1,11.11,80.51,29.75,6,157,163
2011-09-14 23:00:00,4,3,5.93,40.43,30.68,37,3,40
2011-09-15 00:00:00,2,4,20.4,34.03,26.69,12,6,18
2011-09-15 01:00:00,2,1,7.54,68.09,31.5,44,56,100
2011-09-15 02:00:00,1,3,19.08,76.45,8.36,20,29,49
2011-09-15 03:00:00,1,1,32.99,51.58,34.24,36,171,207
2011-09-15 04:00:00,4,4,26.59,23.13,16.79,5,156,161
2011-09-15 05:00:00,1,1,7.32,92.7,22.6,9,89,98
2011-09-15 06:00:00,1,3,11.73,78.46,16.66,26,35,61
2011-09-15 07:00:00,1,3,25.21,41.73,23.7,25,98,123
2011-09-15 08:00:00,4,1,31.84,59.75,31.08,41,112,153
2011-09-15 09:00:00,3,3,5.99,22.22,41.92,27,175,202
2011-09-15 10:00:00,1,1,29.37,47.14,24.17,15,146,161
2011-09-15 11:00:00,1,3,21.85,61.8,16.16,49,190,239
2011-09-15 12:00:00,4,1,21.38,61.38,24.4,27,1,28
2011-09-15 13:00:00,3,1,33.73,36.65,34.44,2,141,143
2011-09-15 14:00:00,1,1,27.43,82.14,17.34,0,112,112
2011-09-15 15:00:00,2,2,30.5,43.91,20.71,2,99,101
2011-09-15 16:00:00,4,3,15.62,66.43,28.14,29,103,132
2011-09-15 17:00:00,1,4,21.63,41.72,14.7,18,111,129
2011-09-15 18:00:00,1,1,23.46,54.01,10.45,32,34,66
2011-09-15 19:00:00,2,2,14.65,36.6,7.02,7,148,155
2011-09-15 20:00:00,2,4,22.11,70.64,17.63,18,144,162
2011-09-15 21:00:00,4,1,12.1,54.05,2.42,35,81,116
2011-09-15 22:00:00,4,4,9.3,21.29,29.17,47,31,78
2011-09-15 23:00:00,2,2,16.22,22.25,8.8,36,150,186
2011-09-16 00:00:00,4,4,27.18,57.69,18.87,4,133,137
2011-09-16 01:00:00,2,1,32.49,34.66,13.46,33,28,61
2011-09-16 02:00:00,1,4,18.73,66.8,31.52,37,62,99
2011-09-16 03:00:00,2,4,24.28,52.66,42.52,26,197,223
2011-09-16 04:00:00,2,1,8.09,72.35,31.67,38,124,162
2011-09-16 05:00:00,3,2,32.13,96.19,27.13,46,95,141
2011-09-16 06:00:00,2,2,22.06,62.3,33.45,41,80,121
2011-09-16 07:00:00,2,4,28.41,82.99,1.5,41,131,172
2011-09-16 08:00:00,3,3,28.83,80.24,6.14,23,57,80
2011-09-16 09:00:00,4,4,12.69,93.74,4.75,47,158,205
2011-09-16 10:00:00,3,3,20.88,37.12,4.91,30,149,179
2011-09-16 11:00:00,1,4,33.81,86.19,13.02,21,154,175
2011-09-16 12:00:00,3,2,7.69,92.44,26.6,22,117,139
2011-09-16 13:00:00,1,4,25.49,51.42,5.73,40,84,124
2011-09-16 14:00:00,4,4,33.87,45.11,46.76,23,83,106
2011-09-16 15:00:00,3,3,14.02,96.16,42.71,39,86,125
2011-09-16 16:00:00,3,2,30.84,70.21,48.58,31,15,46
2011-09-16 17:00:00,4,3,33.01,50.45,2.13,32,5,37
2011-09-16 18:00:00,1,4,27.41,83.35,42.57,27,6,33
2011-09-16 19:00:00,3,1,11.94,44.36,40.19,16,13,29
2011-09-16 20:00:00,1,4,15.02,34.11,45.11,25,2,27
2011-09-16 21:00:00,3,4,6.07,63.52,26.4,17,48,65
2011-09-16 22:00:00,2,3,29.94,65.3,39.39,14,35,49
2011-09-16 23:00:00,3,1,30.49,86.06,2.56,37,28,65
2011-09-17 00:00:00,4,1,23.98,56.56,3.79,21,131,152
2011-09-17 01:00:00,4,3,15.58,85.17,5.93,48,167,215
2011-09-17 02:00:00,1,2,7.3,44.91,45.74,17,168,185
2011-09-17 03:00:00,3,1,27.59,66.03,3.06,20,149,169
2011-09-17 04:00:00,1,1,26.8,36.68,5.01,18,131,149
2011-09-17 05:00:00,1,3,32.38,50.84,46.52,1,120,121
2011-09-17 06:00:00,2,2,26.92,88.6,5.37,29,22,51
2011-09-17 07:00:00,2,2,29.86,37.28,43.49,24,101,125
2011-09-17 08:00:00,4,4,27.38,84.82,39.46,25,131,156
2011-09-17 09:00:00,1,4,23.92,42.63,2.01,38,195,233
2011-09-17 10:00:00,4,3,17.81,22.76,1.09,16,17,33
2011-09-17 11:00:00,3,2,32.06,28.79,26.72,46,0,46
2011-09-17 12:00:00,1,3,24.53,79.67,49.86,15,31,46
2011-09-17 13:00:00,1,4,16.95,40.97,43.94,26,148,174
2011-09-17 14:00:00,3,3,7.5,72.33,15.5,48,165,213
2011-09-17 15:00:00,3,3,13.72,75.94,19.32,2,153,155
2011-09-17 16:00:00,4,1,21.31,47.61,19.4,41,40,81
2011-09-17 17:00:00,4,1,13.27,57.99,36.71,37,176,213
2011-09-17 18:00:00,3,1,11.64,52.3,17.06,28,84,112
2011-09-17 19:00:00,4,4,20.82,95.79,7.39,1,92,93
2011-09-17 20:00:00,3,3,10.09,45.6,37.36,42,116,158
2011-09-17 21:00:00,1,1,29.01,34.67,22.9,39,168,207
2011-09-17 22:00:00,1,1,19.53,49.25,3.84,13,95,108
2011-09-17 23:00:00,2,1,22.22,73.56,39.5,11,58,69
2011-09-18 00:00:00,1,4,9.42,75.79,29.27,23,131,154
2011-09-18 01:00:00,3,4,14.74,93.92,24.47,27,140,167
2011-09-18 02:00:00,4,3,17.3,90.54,33.67,38,60,98
2011-09-18 03:00:00,2,3,29.25,43.07,25.27,17,50,67
2011-09-18 04:00:00,4,3,28.1,56.41,32.42,24,162,186
2011-09-18 05:00:00,3,1,11.69,79.78,43.37,36,90,126
2011-09-18 06:00:00,1,2,23.49,93.32,30.68,5,64,69
2011-09-18 07:00:00,2,4,12.3,46.97,32.98,44,48,92
2011-09-18 08:00:00,3,1,34.65,55.56,30.69,29,176,205
2011-09-18 09:00:00,2,1,33.56,91.96,26.56,30,102,132
2011-09-18 10:00:00,2,3,21.9,48.68,8.6,33,141,174
2011-09-18 11:00:00,1,3,25.97,58.44,16.78,18,164,182
2011-09-18 12:00:00,3,1,29.04,92.36,34.66,27,29,56
2011-09-18 13:00:00,4,4,26.63,84.18,21.27,7,141,148
2011-09-18 14:00:00,2,4,25.99,39.47,20.31,10,91,101
2011-09-18 15:00:00,2,1,33.76,45.98,37.96,15,154,169
2011-09-18 16:00:00,4,2,22.89,48.24,0.28,25,61,86
2011-09-18 17:00:00,3,2,24.09,93.02,33.95,0,2,2
2011-09-18 18:00:00,2,4,30.48,99.91,24.46,30,197,227
2011-09-18 19:00:00,2,3,25.1,81.92,18.84,26,38,64
2011-09-18 20:00:00,2,2,26.99,58.75,17.03,47,18,65
2011-09-18 21:00:00,3,2,12.03,20.81,8.64,43,104,147
2011-09-18 22:00:00,3,3,16.14,75.8,16.71,48,97,145
2011-09-18 23:00:00,4,2,9.42,51.15,19.57,8,127,135
2011-09-19 00:00:00,3,1,20.17,70.64,21.87,25,166,191
2011-09-19 01:00:00,3,2,18.67,68.54,33.62,5,9,14
2011-09-19 02:00:00,1,3,34.91,58.47,22.68,6,174,180
2011-09-19 03:00:00,4,1,23.34,95.55,39.81,12,127,139
2011-09-19 04:00:00,2,2,28.59,21.85,31.99,48,88,136
2011-09-19 05:00:00,3,4,15.02,76.97,9.48,9,150,159
2011-09-19 06:00:00,2,1,29.95,52.79,13.86,42,58,100
2011-09-19 07:00:00,2,1,23.45,77.1,3.96,45,82,127
2011-09-19 08:00:00,1,4,25.91,74.02,47.29,48,101,149
2011-09-19 09:00:00,3,4,13.83,20.82,44.33,30,147,177
2011-09-19 10:00:00,4,2,21.46,42.83,4.24,47,172,219
2011-09-19 11:00:00,3,2,24.02,35.13,28.7,36,43,79
2011-09-19 12:00:00,2,3,22.67,33.36,48.02,17,17,34
2011-09-19 13:00:00,4,3,32.46,78.28,37.36,10,47,57
2011-09-19 14:00:00,3,1,31.95,39.16,24.59,9,74,83
2011-09-19 15:00:00,2,4,34.13,57.98,12.06,27,0,27
2011-09-19 16:00:00,2,4,25.02,39.76,13.95,20,159,179
2011-09-19 17:00:00,1,3,34.16,66.42,36.81,24,96,120
2011-09-19 18:00:00,1,1,29.97,77.65,39.03,5,191,196
2011-09-19 19:00:00,1,1,13.12,46.49,26.43,41,6,47
2011-09-19 20:00:00,2,3,17.82,68.24,6.05,10,94,104
2011-09-19 21:00:00,3,3,12.15,85.99,46.69,32,89,121
2011-09-19 22:00:00,1,3,5.13,27.54,42.24,4,198,202
2011-09-19 23:00:00,3,2,10.64,76.85,7.03,33,99,132
2011-09-20 00:00:00,1,1,5.12,45.85,2.84,31,173,204
2011-09-20 01:00:00,4,1,26.6,29.81,26.79,42,151,193
2011-09-20 02:00:00,4,1,17.77,63.65,14.21,45,68,113
2011-09-20 03:00:00,1,3,14.38,38.1,14.16,23,107,130
2011-09-20 04:00:00,2,3,27.85,85.71,4.36,12,163,175
2011-09-20 05:00:00,1,3,29.97,23.43,47.67,42,194,236
2011-09-20 06:00:00,1,3,34.26,27.89,41.51,5,49,54
2011-09-20 07:00:00,2,4,24.26,61.68,5.69,33,186,219
2011-09-20 08:00:00,4,3,18.85,67.12,43.83,24,185,209
2011-09-20 09:00:00,3,2,14.16,78.39,34.15,40,45,85
2011-09-20 10:00:00,1,4,11.67,40.74,16.27,22,197,219
2011-09-20 11:00:00,2,4,11.39,87.34,43.56,49,22,71
2011-09-20 12:00:00,1,3,17.28,96.25,29.9,45,11,56
2011-09-20 13:00:00,2,1,34.75,59.92,42.43,12,155,167
2011-09-20 14:00:00,3,3,5.03,80.84,23.46,27,185,212
2011-09-20 15:00:00,3,1,10.92,61.99,25.03,43,60,103
2011-09-20 16:00:00,4,3,10.65,25.56,14.55,43,182,225
2011-09-20 17:00:00,2,3,26.51,46.09,19.38,12,33,45
2011-09-20 18:00:00,2,1,15.57,27.0,28.39,6,93,99
2011-09-20 19:00:00,4,1,18.72,99.11,47.35,47,100,147
2011-09-20 20:00:00,4,1,9.46,38.32,30.01,16,17,33
2011-09-20 21:00:00,2,1,17.15,70.87,7.37,8,119,127
2011-09-20 22:00:00,4,2,8.1,42.75,0.35,13,162,175
2011-09-20 23:00:00,3,1,20.99,72.26,42.55,29,175,204
2011-09-21 00:00:00,1,3,7.94,36.83,18.22,40,36,76
2011-09-21 01:00:00,3,3,28.72,82.82,15.75,37,40,77
2011-09-21 02:00:00,4,2,22.0,28.86,40.04,29,133,162
2011-09-21 03:00:00,2,1,26.72,91.61,47.27,32,127,159
2011-09-21 04:00:00,2,3,17.56,87.23,37.4,24,85,109
2011-09-21 05:00:00,3,2,16.44,74.3,8.69,30,90,120
2011-09-21 06:00:00,2,3,7.95,25.39,19.57,22,38,60
2011-09-21 07:00:00,4,2,20.72,36.69,37.97,26,3,29
2011-09-21 08:00:00,3,2,20.44,88.75,45.35,32,143,175
2011-09-21 09:00:00,2,4,19.04,29.76,49.93,46,51,97
2011-09-21 10:00:00,1,4,27.22,32.47,25.58,48,112,160
2011-09-21 11:00:00,1,1,29.98,63.52,41.13,19,18,37
2011-09-21 12:00:00,4,4,27.52,41.93,2.33,27,91,118
2011-09-21 13:00:00,2,2,9.32,37.77,14.29,7,120,127
2011-09-21 14:00:00,4,3,23.66,66.07,18.58,21,16,37
2011-09-21 15:00:00,3,3,7.41,49.81,48.78,34,172,206
2011-09-21 16:00:00,1,1,25.84,31.24,0.17,30,129,159
2011-09-21 17:00:00,3,4,16.46,62.79,15.4,43,129,172
2011-09-21 18:00:00,2,1,8.97,50.96,46.52,23,87,110
2011-09-21 19:00:00,4,2,30.86,78.76,15.33,14,54,68
2011-09-21 20:00:00,4,4,23.42,28.22,11.25,49,90,139
2011-09-21 21:00:00,4,1,15.64,69.65,36.5,44,3,47
2011-09-21 22:00:00,3,3,5.92,54.92,37.27,30,122,152
2011-09-21 23:00:00,1,3,21.12,52.48,23.61,4,99,103
2011-09-22 00:00:00,3,1,32.7,38.58,47.35,21,139,160
2011-09-22 01:00:00,3,1,22.89,22.43,10.14,16,181,197
2011-09-22 02:00:00,2,1,34.15,87.82,45.67,27,59,86
2011-09-22 03:00:00,2,2,9.09,46.11,37.78,2,28,30
2011-09-22 04:00:00,2,2,22.05,74.49,18.41,18,188,206
2011-09-22 05:00:00,1,3,28.94,95.81,40.35,37,45,82
2011-09-22 06:00:00,1,2,20.77,65.2,6.66,26,96,122
2011-09-22 07:00:00,2,2,7.73,51.77,6.55,16,48,64
2011-09-22 08:00:00,2,4,22.49,41.46,46.5,31,119,150
2011-09-22 09:00:00,1,2,23.35,94.72,4.74,36,145,181
2011-09-22 10:00:00,4,4,26.86,74.57,0.2,20,75,95
2011-09-22 11:00:00,1,2,27.84,73.22,19.45,36,73,109
2011-09-22 12:00:00,1,3,28.12,54.09,5.19,10,151,161
2011-09-22 13:00:00,1,1,24.9,87.6,43.15,0,16,16
2011-09-22 14:00:00,2,3,11.47,77.09,46.13,29,106,135
2011-09-22 15:00:00,4,2,17.13,42.65,24.12,25,95,120
2011-09-22 16:00:00,1,1,28.28,67.97,21.27,44,183,227
2011-09-22 17:00:00,2,1,33.6,54.42,26.95,48,88,136
2011-09-22 18:00:00,3,1,7.37,20.53,11.31,42,51,93
2011-09-22 19:00:00,3,4,21.07,84.61,14.9,49,70,119
2011-09-22 20:00:00,1,3,14.38,29.83,5.05,35,19,54
2011-09-22 21:00:00,3,4,11.76,60.8,22.32,25,156,181
2011-09-22 22:00:00,4,1,20.17,46.9,30.58,41,82,123
2011-09-22 23:00:00,3,3,23.18,47.37,46.51,26,177,203
2011-09-23 00:00:00,3,3,5.29,58.19,36.95,25,118,143
2011-09-23 01:00:00,4,2,28.41,99.76,36.15,42,117,159
2011-09-23 02:00:00,1,4,29.6,52.67,15.4,17,142,159
2011-09-23 03:00:00,1,4,33.97,34.59,44.41,32,158,190
2011-09-23 04:00:00,4,2,10.42,69.09,47.35,35,12,47
2011-09-23 05:00:00,4,4,22.84,38.9,46.61,36,55,91
2011-09-23 06:00:00,4,1,17.8,28.44,1.94,33,18,51
2011-09-23 07:00:00,3,1,15.04,24.01,30.22,25,69,94
2011-09-23 08:00:00,4,4,21.97,21.83,32.16,21,155,176
2011-09-23 09:00:00,2,2,28.47,54.49,14.75,23,149,172
2011-09-23 10:00:00,3,3,5.69,54.14,49.62,11,155,166
2011-09-23 11:00:00,1,4,34.08,34.84,14.56,10,79,89
2011-09-23 12:00:00,1,3,29.3,82.72,10.83,20,113,133
2011-09-23 13:00:00,1,2,27.53,30.34,24.21,15,32,47
2011-09-23 14:00:00,3,3,27.81,93.23,16.16,35,113,148
2011-09-23 15:00:00,2,2,16.67,67.01,46.2,6,172,178
2011-09-23 16:00:00,4,2,27.55,22.21,22.0,27,175,202
2011-09-23 17:00:00,4,1,16.6,97.04,20.51,23,114,137
2011-09-23 18:00:00,1,1,31.96,44.64,31.29,12,62,74
2011-09-23 19:00:00,1,2,10.32,56.0,4.06,13,25,38
2011-09-23 20:00:00,3,4,13.77,42.74,37.84,42,86,128
2011-09-23 21:00:00,2,1,21.54,78.27,38.42,30,0,30
2011-09-23 22:00:00,4,2,14.58,58.85,23.7,7,189,196
2011-09-23 23:00:00,3,3,17.73,30.59,47.78,0,92,92
2011-09-24 00:00:00,4,3,19.77,28.34,28.97,39,199,238
2011-09-24 01:00:00,1,4,30.69,78.03,34.76,16,105,121
2011-09-24 02:00:00,4,3,20.7,38.97,46.22,40,130,170
2011-09-24 03:00:00,2,3,15.87,31.02,33.32,12,83,95
2011-09-24 04:00:00,2,2,12.43,59.95,21.59,46,106,152
2011-09-24 05:00:00,1,3,17.26,84.22,1.24,26,115,141
2011-09-24 06:00:00,2,3,20.47,42.3,36.41,12,4,16
2011-09-24 07:00:00,2,3,27.38,42.11,48.24,39,172,211
2011-09-24 08:00:00,3,3,8.63,86.71,23.51,26,11,37
2011-09-24 09:00:00,4,2,11.65,31.83,16.99,31,47,78
2011-09-24 10:00:00,1,3,16.39,69.34,25.96,11,13,24
2011-09-24 11:00:00,1,4,15.81,96.4,36.42,42,52,94
2011-09-24 12:00:00,1,1,16.75,87.3,0.03,12,44,56
2011-09-24 13:00:00,1,4,28.81,24.95,44.36,15,159,174
2011-09-24 14:00:00,1,1,14.72,45.59,44.32,33,157,190
2011-09-24 15:00:00,2,4,20.06,31.39,27.06,5,11,16
2011-09-24 16:00:00,3,1,23.72,95.94,6.12,47,99,146
2011-09-24 17:00:00,1,1,11.97,98.88,33.59,17,82,99
2011-09-24 18:00:00,3,1,26.56,38.8,6.89,16,43,59
2011-09-24 19:00:00,3,1,21.41,73.58,25.38,46,152,198
2011-09-24 20:00:00,2,2,18.4,87.33,4.68,38,169,207
2011-09-24 21:00:00,1,4,29.29,38.69,29.45,13,20,33
2011-09-24 22:00:00,2,1,12.3,35.01,15.9,6,188,194
2011-09-24 23:00:00,1,4,31.5,20.9,41.55,5,65,70
2011-09-25 00:00:00,2,3,21.83,52.96,40.0,11,100,111
2011-09-25 01:00:00,3,1,23.28,91.95,49.92,33,20,53
2011-09-25 02:00:00,1,4,31.25,92.24,12.88,0,25,25
2011-09-25 03:00:00,4,2,29.53,30.22,3.09,49,159,208
2011-09-25 04:00:00,3,4,23.05,36.35,22.15,28,16,44
2011-09-25 05:00:00,4,1,27.6,52.64,4.17,27,3,30
2011-09-25 06:00:00,3,3,18.0,82.45,8.92,4,38,42
2011-09-25 07:00:00,2,4,21.42,68.95,29.87,20,14,34
2011-09-25 08:00:00,1,3,6.86,61.11,29.61,38,32,70
2011-09-25 09:00:00,3,2,7.7,67.35,2.17,46,188,234
2011-09-25 10:00:00,2,4,29.88,27.7,22.15,37,141,178
2011-09-25 11:00:00,1,4,6.79,58.21,26.51,33,89,122
2011-09-25 12:00:00,1,2,10.08,99.37,13.4,20,46,66
2011-09-25 13:00:00,3,2,28.87,27.08,43.6,23,129,152
2011-09-25 14:00:00,1,2,5.03,61.54,8.05,48,89,137
2011-09-25 15:00:00,3,1,13.47,43.65,12.7,12,65,77
2011-09-25 16:00:00,1,1,22.52,63.19,7.85,44,175,219
2011-09-25 17:00:00,4,4,22.86,65.91,5.83,45,191,236
2011-09-25 18:00:00,2,4,28.31,66.2,43.95,22,193,215
2011-09-25 19:00:00,4,4,20.18,88.18,13.89,31,175,206
2011-09-25 20:00:00,3,3,20.28,51.18,36.13,7,80,87
2011-09-25 21:00:00,4,2,26.76,61.31,21.4,46,17,63
2011-09-25 22:00:00,3,4,19.96,20.87,31.79,10,178,188
2011-09-25 23:00:00,1,2,23.25,83.16,46.41,12,131,143
2011-09-26 00:00:00,1,1,31.93,40.76,42.23,19,80,99
2011-09-26 01:00:00,3,2,17.04,85.32,3.45,0,160,160
2011-09-26 02:00:00,4,3,16.55,41.25,42.26,1,150,151
2011-09-26 03:00:00,1,3,5.11,20.86,22.59,10,180,190
2011-09-26 04:00:00,2,2,23.4,32.39,17.51,45,12,57
2011-09-26 05:00:00,1,3,5.89,98.85,33.62,29,70,99
2011-09-26 06:00:00,2,3,20.12,45.58,47.51,4,57,61
2011-09-26 07:00:00,4,1,29.13,28.71,4.71,6,190,196
2011-09-26 08:00:00,2,4,21.5,29.5,38.4,23,64,87
2011-09-26 09:00:00,2,3,13.09,44.83,10.18,30,103,133
2011-09-26 10:00:00,2,4,28.59,23.01,19.01,47,41,88
2011-09-26 11:00:00,2,2,13.09,60.92,43.69,29,94,123
2011-09-26 12:00:00,1,2,26.99,37.1,27.29,42,99,141
2011-09-26 13:00:00,2,3,23.31,61.54,3.37,14,88,102
2011-09-26 14:00:00,1,2,10.1,31.26,25.4,35,108,143
2011-09-26 15:00:00,2,1,32.15,54.39,39.48,9,113,122
2011-09-26 16:00:00,3,3,11.02,67.83,26.44,0,39,39
2011-09-26 17:00:00,4,3,34.69,24.96,8.34,6,93,99
2011-09-26 18:00:00,2,3,5.22,51.9,22.25,43,101,144
2011-09-26 19:00:00,3,2,12.9,44.2,46.22,25,20,45
2011-09-26 20:00:00,2,2,11.0,39.23,32.91,42,82,124
2011-09-26 21:00:00,2,3,5.42,68.36,36.49,42,160,202
2011-09-26 22:00:00,2,4,26.97,67.08,39.3,48,110,158
2011-09-26 23:00:00,3,2,25.8,70.46,4.53,29,197,226
2011-09-27 00:00:00,4,2,28.77,32.71,29.08,0,41,41
2011-09-27 01:00:00,3,3,12.7,42.86,18.8,14,36,50
2011-09-27 02:00:00,4,4,18.33,36.77,6.96,19,199,218
2011-09-27 03:00:00,2,3,24.77,63.24,10.14,21,128,149
2011-09-27 04:00:00,1,2,18.19,56.89,39.06,24,76,100
2011-09-27 05:00:00,2,3,25.92,46.42,8.07,49,153,202
2011-09-27 06:00:00,4,3,24.02,82.88,15.62,35,112,147
2011-09-27 07:00:00,3,3,8.44,27.52,14.24,36,38,74
2011-09-27 08:00:00,2,4,28.43,97.99,2.43,45,46,91
2011-09-27 09:00:00,3,3,26.62,29.32,23.11,44,55,99
2011-09-27 10:00:00,3,2,24.68,81.85,38.3,26,109,135
2011-09-27 11:00:00,3,3,9.65,49.46,1.11,18,185,203
2011-09-27 12:00:00,2,4,13.04,89.22,5.63,18,155,173
2011-09-27 13:00:00,3,1,16.8,25.93,36.01,15,184,199
2011-09-27 14:00:00,3,4,13.4,49.98,29.68,20,70,90
2011-09-27 15:00:00,2,3,11.83,46.84,35.76,32,109,141
2011-09-27 16:00:00,3,1,29.16,99.45,11.51,41,199,240
2011-09-27 17:00:00,2,3,24.15,98.84,40.19,30,172,202
2011-09-27 18:00:00,4,4,21.96,35.18,23.99,33,64,97
2011-09-27 19:00:00,4,1,11.78,70.4,30.52,14,3,17
2011-09-27 20:00:00,4,1,32.54,62.84,4.61,35,188,223
2011-09-27 21:00:00,3,3,10.74,32.35,10.25,25,60,85
2011-09-27 22:00:00,1,3,28.85,33.42,38.67,29,170,199
2011-09-27 23:00:00,1,4,34.0,99.14,11.2,30,104,134
2011-09-28 00:00:00,3,3,26.81,56.22,4.63,24,146,170
2011-09-28 01:00:00,1,1,34.79,30.06,29.86,3,85,88
2011-09-28 02:00:00,2,2,24.53,37.18,27.4,11,99,110
2011-09-28 03:00:00,1,2,11.52,41.47,30.39,18,128,146
2011-09-28 04:00:00,3,4,11.11,60.87,30.92,8,146,154
2011-09-28 05:00:00,3,3,14.74,46.84,25.01,24,50,74
2011-09-28 06:00:00,2,4,5.21,56.4,24.69,47,63,110
2011-09-28 07:00:00,4,2,25.45,33.32,46.21,46,62,108
2011-09-28 08:00:00,3,2,13.06,46.14,26.69,40,28,68
2011-09-28 09:00:00,2,3,29.46,25.63,30.87,49,146,195
2011-09-28 10:00:00,1,1,15.78,91.18,13.35,6,42,48
2011-09-28 11:00:00,1,3,19.4,35.9,43.55,26,69,95
2011-09-28 12:00:00,2,2,33.97,80.55,1.22,47,38,85
2011-09-28 13:00:00,2,1,12.27,47.96,27.86,46,22,68
2011-09-28 14:00:00,3,4,26.64,57.95,19.19,42,0,42
2011-09-28 15:00:00,1,2,27.65,43.3,30.2,5,60,65
2011-09-28 16:00:00,2,4,11.63,75.72,18.01,34,24,58
2011-09-28 17:00:00,1,1,20.03,87.56,35.88,31,131,162
2011-09-28 18:00:00,2,4,15.51,42.9,1.02,13,108,121
2011-09-28 19:00:00,1,2,28.16,39.38,20.29,5,107,112
2011-09-28 20:00:00,4,3,23.67,74.52,41.56,48,0,48
2011-09-28 21:00:00,3,4,19.28,35.61,12.51,17,39,56
2011-09-28 22:00:00,1,2,28.38,71.19,2.64,30,20,50
2011-09-28 23:00:00,4,2,12.05,27.55,24.83,15,170,185
2011-09-29 00:00:00,1,1,27.61,69.61,48.83,2,137,139
2011-09-29 01:00:00,1,2,30.96,61.07,3.21,30,65,95
2011-09-29 02:00:00,4,3,31.36,29.11,3.5,37,16,53
2011-09-29 03:00:00,1,3,28.51,71.93,29.76,16,123,139
2011-09-29 04:00:00,1,4,17.24,55.72,12.5,4,140,144
2011-09-29 05:00:00,3,4,34.45,37.37,20.51,15,90,105
2011-09-29 06:00:00,4,4,16.39,48.27,41.53,16,112,128
2011-09-29 07:00:00,4,4,24.16,59.37,9.94,30,125,155
2011-09-29 08:00:00,2,3,9.83,27.32,35.96,15,9,24
2011-09-29 09:00:00,1,1,34.41,96.61,25.22,20,179,199
2011-09-29 10:00:00,3,4,26.12,73.24,45.25,40,137,177
2011-09-29 11:00:00,1,1,27.6,28.2,48.65,38,46,84
2011-09-29 12:00:00,1,2,6.97,85.83,24.25,36,8,44
2011-09-29 13:00:00,2,2,27.9,45.8,29.23,40,45,85
2011-09-29 14:00:00,1,4,28.24,67.74,37.29,9,116,125
2011-09-29 15:00:00,3,2,25.15,42.17,15.93,31,102,133
2011-09-29 16:00:00,3,1,13.76,78.67,11.34,24,123,147
2011-09-29 17:00:00,2,1,19.69,77.84,48.23,32,67,99
2011-09-29 18:00:00,1,2,8.31,64.16,21.63,38,108,146
2011-09-29 19:00:00,3,4,19.15,39.27,0.08,36,181,217
2011-09-29 20:00:00,1,1,12.31,40.3,41.89,37,67,104
2011-09-29 21:00:00,1,1,15.47,50.63,29.98,37,131,168
2011-09-29 22:00:00,1,3,9.88,31.6,8.43,27,104,131
2011-09-29 23:00:00,2,4,11.9,47.01,1.51,14,128,142
2011-09-30 00:00:00,1,3,7.3,74.75,14.57,7,58,65
2011-09-30 01:00:00,3,2,32.6,86.47,46.39,0,152,152
2011-09-30 02:00:00,1,2,20.91,46.61,46.67,9,136,145
2011-09-30 03:00:00,3,3,16.9,38.69,15.55,34,24,58
2011-09-30 04:00:00,1,4,21.05,86.61,41.8,47,81,128
2011-09-30 05:00:00,3,1,23.85,91.26,22.09,32,198,230
2011-09-30 06:00:00,3,2,32.66,52.8,32.72,15,153,168
2011-09-30 07:00:00,1,4,10.36,22.15,16.72,13,55,68
2011-09-30 08:00:00,1,4,13.87,75.6,25.8,4,48,52
2011-09-30 09:00:00,3,2,34.27,82.72,14.69,15,64,79
2011-09-30 10:00:00,4,2,16.14,21.44,3.06,20,188,208
2011-09-30 11:00:00,2,4,5.68,67.6,6.97,10,8,18
2011-09-30 12:00:00,4,1,9.43,67.07,14.53,49,137,186
2011-09-30 13:00:00,4,3,5.79,50.3,48.81,6,111,117
2011-09-30 14:00:00,1,2,34.7,79.98,48.28,7,138,145
2011-09-30 15:00:00,2,3,13.37,54.25,41.38,16,95,111
2011-09-30 16:00:00,4,4,32.71,74.14,11.63,29,84,113
2011-09-30 17:00:00,1,3,34.88,61.37,22.08,13,35,48
2011-09-30 18:00:00,4,1,23.0,39.88,21.99,48,183,231
2011-09-30 19:00:00,4,4,6.0,68.52,19.35,43,159,202
2011-09-30 20:00:00,1,1,7.45,78.95,2.24,49,82,131
2011-09-30 21:00:00,1,4,19.45,97.91,26.73,32,199,231
2011-09-30 22:00:00,1,1,17.19,50.41,3.64,23,162,185
2011-09-30 23:00:00,2,4,23.19,25.16,40.1,6,131,137
2011-10-01 00:00:00,4,1,18.17,99.04,34.57,37,61,98
2011-10-01 01:00:00,1,4,33.02,69.9,17.64,14,62,76
2011-10-01 02:00:00,3,1,21.04,95.72,32.36,49,135,184
2011-10-01 03:00:00,4,4,25.81,28.31,11.65,42,118,160
2011-10-01 04:00:00,3,1,31.89,47.36,13.26,24,75,99
2011-10-01 05:00:00,2,2,9.41,30.71,15.71,16,68,84
2011-10-01 06:00:00,1,3,11.89,86.84,39.85,32,188,220
2011-10-01 07:00:00,3,4,8.22,90.43,10.53,1,93,94
2011-10-01 08:00:00,2,1,9.19,60.1,28.14,38,62,100
2011-10-01 09:00:00,1,2,20.38,34.93,10.02,9,60,69
2011-10-01 10:00:00,3,4,14.64,30.17,14.25,13,98,111
2011-10-01 11:00:00,3,4,17.7,67.05,11.77,11,36,47
2011-10-01 12:00:00,2,4,34.47,60.51,32.25,16,3,19
2011-10-01 13:00:00,1,3,9.7,75.58,26.34,13,55,68
2011-10-01 14:00:00,1,1,21.22,44.42,36.06,9,42,51
2011-10-01 15:00:00,3,1,7.97,52.19,11.0,43,20,63
2011-10-01 16:00:00,3,4,14.55,21.71,0.46,38,57,95
2011-10-01 17:00:00,3,4,20.83,68.81,34.03,39,143,182
2011-10-01 18:00:00,1,4,33.4,53.85,5.74,28,52,80
2011-10-01 19:00:00,2,2,16.74,93.58,12.32,44,17,61
2011-10-01 20:00:00,2,4,6.95,71.34,15.28,5,56,61
2011-10-01 21:00:00,1,3,16.64,51.9,37.34,39,94,133
2011-10-01 22:00:00,4,1,9.37,41.09,31.29,30,165,195
2011-10-01 23:00:00,2,3,11.9,92.42,9.21,36,122,158
2011-10-02 00:00:00,3,4,23.54,21.3,29.89,8,31,39
2011-10-02 01:00:00,4,2,7.02,46.15,35.41,42,111,153
2011-10-02 02:00:00,4,4,18.94,95.48,19.44,44,18,62
2011-10-02 03:00:00,2,4,23.28,72.32,12.3,32,83,115
2011-10-02 04:00:00,4,4,17.66,62.62,33.95,6,47,53
2011-10-02 05:00:00,4,4,5.57,36.28,30.54,37,73,110
2011-10-02 06:00:00,2,4,34.57,86.67,3.9,7,153,160
2011-10-02 07:00:00,2,1,16.01,36.34,33.33,33,109,142
2011-10-02 08:00:00,4,3,28.36,39.86,24.43,16,81,97
2011-10-02 09:00:00,3,2,14.77,35.35,37.67,16,172,188
2011-10-02 10:00:00,1,4,19.25,32.65,9.54,29,172,201
2011-10-02 11:00:00,4,2,16.65,96.26,12.91,17,14,31
2011-10-02 12:00:00,4,1,15.28,68.16,27.17,38,145,183
2011-10-02 13:00:00,3,3,5.66,71.03,24.09,14,30,44
2011-10-02 14:00:00,4,4,15.8,96.35,19.32,44,142,186
2011-10-02 15:00:00,4,1,31.68,38.45,37.3,19,101,120
2011-10-02 16:00:00,1,1,25.71,20.47,28.24,24,14,38
2011-10-02 17:00:00,1,3,9.36,67.91,35.51,13,64,77
2011-10-02 18:00:00,1,4,22.73,60.63,7.66,26,104,130
2011-10-02 19:00:00,2,3,31.77,58.21,36.45,46,173,219
2011-10-02 20:00:00,2,3,26.0,24.95,23.08,34,74,108
2011-10-02 21:00:00,1,2,9.46,56.35,1.69,27,101,128
2011-10-02 22:00:00,1,2,31.03,43.0,11.72,5,143,148
2011-10-02 23:00:00,2,3,14.05,41.97,1.29,40,182,222
2011-10-03 00:00:00,3,2,18.62,37.79,22.84,30,29,59
2011-10-03 01:00:00,4,1,20.78,46.6,16.29,13,40,53
2011-10-03 02:00:00,4,3,30.52,48.25,49.37,15,66,81
2011-10-03 03:00:00,1,4,32.95,44.7,43.43,48,16,64
2011-10-03 04:00:00,3,4,32.89,98.3,41.28,43,25,68
2011-10-03 05:00:00,2,1,5.24,94.62,25.06,35,117,152
2011-10-03 06:00:00,1,4,32.66,65.96,40.35,4,72,76
2011-10-03 07:00:00,3,4,6.63,98.48,13.34,31,100,131
2011-10-03 08:00:00,3,3,12.97,99.3,28.03,10,191,201
2011-10-03 09:00:00,3,1,20.45,48.48,19.65,21,94,115
2011-10-03 10:00:00,2,3,19.4,55.62,8.57,42,57,99
2011-10-03 11:00:00,2,1,23.14,96.72,3.63,39,94,133
2011-10-03 12:00:00,4,3,19.38,68.69,27.91,27,101,128
2011-10-03 13:00:00,4,3,33.03,37.03,4.88,49,130,179
2011-10-03 14:00:00,3,2,12.22,75.15,35.9,5,119,124
2011-10-03 15:00:00,3,4,13.22,36.46,46.07,38,125,163
2011-10-03 16:00:00,2,1,32.62,47.15,8.11,5,112,117
2011-10-03 17:00:00,4,4,7.3,38.2,23.55,45,155,200
2011-10-03 18:00:00,3,2,23.29,39.6,36.94,19,131,150
2011-10-03 19:00:00,4,1,25.45,20.37,14.34,37,167,204
2011-10-03 20:00:00,4,2,20.17,90.46,46.04,3,101,104
2011-10-03 21:00:00,3,4,25.83,43.68,44.42,24,56,80
2011-10-03 22:00:00,2,3,10.18,26.91,5.19,12,192,204
2011-10-03 23:00:00,3,2,30.58,26.96,1.37,48,174,222
2011-10-04 00:00:00,3,2,9.2,64.48,48.82,11,161,172
2011-10-04 01:00:00,4,3,17.02,99.43,47.82,8,172,180
2011-10-04 02:00:00,3,4,7.26,31.6,21.11,2,31,33
2011-10-04 03:00:00,2,2,21.36,27.97,2.53,31,171,202
2011-10-04 04:00:00,3,4,25.09,55.06,30.94,10,96,106
2011-10-04 05:00:00,2,3,33.24,65.07,14.67,4,138,142
2011-10-04 06:00:00,2,1,27.18,43.55,46.84,34,35,69
2011-10-04 07:00:00,4,2,21.23,44.2,39.73,48,140,188
2011-10-04 08:00:00,1,4,32.98,53.96,32.48,23,56,79
2011-10-04 09:00:00,1,3,19.35,45.13,14.23,40,152,192
2011-10-04 10:00:00,4,3,21.84,93.23,35.06,5,197,202
2011-10-04 11:00:00,3,2,22.88,23.36,14.46,17,164,181
2011-10-04 12:00:00,4,1,17.3,38.77,1.88,37,89,126
2011-10-04 13:00:00,2,2,30.15,84.68,25.42,5,131,136
2011-10-04 14:00:00,1,4,10.56,86.72,24.43,21,108,129
2011-10-04 15:00:00,4,3,21.65,28.92,38.15,41,25,66
2011-10-04 16:00:00,3,1,26.67,97.9,43.28,42,12,54
2011-10-04 17:00:00,4,4,32.12,75.47,17.72,13,71,84
2011-10-04 18:00:00,1,2,31.52,41.81,22.47,11,178,189
2011-10-04 19:00:00,4,3,20.26,56.48,23.52,24,46,70
2011-10-04 20:00:00,4,2,24.29,43.77,16.21,19,124,143
2011-10-04 21:00:00,1,1,16.83,32.0,37.17,17,160,177
2011-10-04 22:00:00,2,1,19.05,43.29,26.11,23,169,192
2011-10-04 23:00:00,2,1,32.19,66.41,45.7,14,127,141
2011-10-05 00:00:00,1,1,32.92,86.08,32.52,30,30,60
2011-10-05 01:00:00,4,1,31.86,49.08,10.59,41,167,208
2011-10-05 02:00:00,1,2,9.15,47.83,8.24,0,115,115
2011-10-05 03:00:00,2,1,30.5,57.44,18.62,14,143,157
2011-10-05 04:00:00,3,1,33.45,71.56,17.35,33,55,88
2011-10-05 05:00:00,4,3,15.84,80.13,20.36,1,73,74
2011-10-05 06:00:00,2,1,20.56,46.14,9.18,35,35,70
2011-10-05 07:00:00,4,3,28.37,66.91,48.91,22,95,117
2011-10-05 08:00:00,1,3,21.86,51.15,7.29,23,79,102
2011-10-05 09:00:00,3,3,34.8,77.31,32.63,45,183,228
2011-10-05 10:00:00,1,2,18.67,33.17,0.65,31,47,78
2011-10-05 11:00:00,3,2,26.42,40.55,20.35,45,57,102
2011-10-05 12:00:00,4,4,28.78,54.08,15.46,12,14,26
2011-10-05 13:00:00,4,4,19.82,91.15,19.1,32,199,231
2011-10-05 14:00:00,1,3,30.71,65.87,24.9,41,142,183
2011-10-05 15:00:00,3,2,21.38,97.23,30.02,13,148,161
2011-10-05 16:00:00,3,1,17.35,28.26,29.18,16,63,79
2011-10-05 17:00:00,4,4,8.23,56.81,31.54,15,134,149
2011-10-05 18:00:00,1,2,16.8,53.53,42.23,31,51,82
2011-10-05 19:00:00,3,1,27.02,68.02,44.34,14,18,32
2011-10-05 20:00:00,4,1,32.64,84.96,36.86,42,124,166
2011-10-05 21:00:00,2,2,12.55,87.32,3.95,30,85,115
2011-10-05 22:00:00,1,4,15.66,73.62,48.06,11,173,184
2011-10-05 23:00:00,2,2,9.62,71.32,47.37,32,37,69
2011-10-06 00:00:00,1,4,25.72,95.92,35.59,2,140,142
2011-10-06 01:00:00,4,3,33.81,50.69,25.87,10,43,53
2011-10-06 02:00:00,3,2,24.23,86.62,12.53,42,149,191
2011-10-06 03:00:00,3,2,23.51,93.72,37.82,4,198,202
2011-10-06 04:00:00,3,4,21.6,59.32,43.89,46,34,80
2011-10-06 05:00:00,1,4,7.65,78.33,33.26,26,130,156
2011-10-06 06:00:00,4,2,26.89,50.16,31.45,15,110,125
2011-10-06 07:00:00,2,1,23.06,32.71,9.65,34,143,177
2011-10-06 08:00:00,4,1,24.84,66.92,17.89,39,172,211
2011-10-06 09:00:00,2,1,31.96,35.72,36.16,15,143,158
2011-10-06 10:00:00,1,3,28.52,56.61,0.84,15,193,208
2011-10-06 11:00:00,1,3,28.43,89.83,32.06,21,101,122
2011-10-06 12:00:00,2,4,32.82,26.88,38.33,3,80,83
2011-10-06 13:00:00,2,3,34.7,22.43,16.74,31,165,196
2011-10-06 14:00:00,2,1,22.44,68.52,3.81,26,23,49
2011-10-06 15:00:00,4,2,8.27,46.48,40.96,14,177,191
2011-10-06 16:00:00,2,3,18.77,53.44,7.09,18,107,125
2011-10-06 17:00:00,1,3,28.63,52.46,18.54,25,56,81
2011-10-06 18:00:00,1,1,5.83,26.93,35.36,14,122,136
2011-10-06 19:00:00,3,3,6.71,20.29,40.85,44,55,99
2011-10-06 20:00:00,2,4,7.01,91.87,43.12,9,85,94
2011-10-06 21:00:00,4,2,26.93,37.42,26.52,33,65,98
2011-10-06 22:00:00,4,1,20.03,54.09,23.79,37,77,114
2011-10-06 23:00:00,4,4,16.07,97.75,42.42,48,91,139
2011-10-07 00:00:00,3,1,8.17,86.14,28.15,25,76,101
2011-10-07 01:00:00,1,4,26.97,28.63,28.93,7,101,108
2011-10-07 02:00:00,4,2,14.63,60.68,21.7,15,80,95
2011-10-07 03:00:00,1,2,12.96,78.41,18.64,28,72,100
2011-10-07 04:00:00,3,4,24.57,75.87,24.03,31,61,92
2011-10-07 05:00:00,2,4,21.77,80.87,18.24,20,13,33
2011-10-07 06:00:00,2,4,15.87,56.6,17.18,31,193,224
2011-10-07 07:00:00,2,4,24.24,34.07,49.68,44,187,231
2011-10-07 08:00:00,4,4,13.14,57.19,16.81,11,20,31
2011-10-07 09:00:00,2,4,28.84,71.83,12.82,47,162,209
2011-10-07 10:00:00,4,2,11.88,68.69,17.7,38,29,67
2011-10-07 11:00:00,3,4,9.77,25.64,29.54,9,166,175
2011-10-07 12:00:00,3,3,28.47,25.2,45.55,5,24,29
2011-10-07 13:00:00,4,2,26.24,97.22,39.39,36,171,207
2011-10-07 14:00:00,1,1,10.48,32.14,42.11,17,186,203
2011-10-07 15:00:00,2,2,8.49,43.56,42.95,47,98,145
2011-10-07 16:00:00,2,1,30.15,81.41,46.03,30,133,163
2011-10-07 17:00:00,2,1,28.3,52.77,11.75,34,130,164
2011-10-07 18:00:00,4,3,14.82,34.52,22.92,2,163,165
2011-10-07 19:00:00,3,4,24.75,57.38,19.26,4,111,115
2011-10-07 20:00:00,2,4,8.72,65.52,19.09,33,110,143
2011-10-07 21:00:00,3,2,20.21,56.22,32.61,32,128,160
2011-10-07 22:00:00,2,4,5.56,93.52,20.09,35,161,196
2011-10-07 23:00:00,2,3,16.75,42.78,30.82,9,64,73
2011-10-08 00:00:00,4,2,7.25,72.91,19.11,44,25,69
2011-10-08 01:00:00,1,2,19.25,28.98,15.56,2,17,19
2011-10-08 02:00:00,4,2,17.65,51.38,17.65,10,163,173
2011-10-08 03:00:00,2,4,18.33,79.28,40.19,2,133,135
2011-10-08 04:00:00,2,4,6.36,37.99,30.05,27,171,198
2011-10-08 05:00:00,1,4,15.85,67.18,48.7,41,39,80
2011-10-08 06:00:00,3,2,27.69,32.27,41.63,27,29,56
2011-10-08 07:00:00,3,2,16.07,28.22,24.29,8,77,85
2011-10-08 08:00:00,2,1,26.46,61.86,12.12,25,73,98
2011-10-08 09:00:00,3,1,16.08,74.0,33.7,28,30,58
2011-10-08 10:00:00,2,4,17.7,29.07,36.33,9,185,194
2011-10-08 11:00:00,1,2,21.92,93.42,23.21,26,182,208
2011-10-08 12:00:00,1,4,33.52,38.06,11.5,44,163,207
2011-10-08 13:00:00,2,4,8.27,29.6,27.86,31,78,109
2011-10-08 14:00:00,1,1,5.99,36.22,12.69,17,157,174
2011-10-08 15:00:00,4,3,23.24,33.57,47.0,17,47,64
2011-10-08 16:00:00,4,4,33.47,27.25,31.44,21,77,98
2011-10-08 17:00:00,1,3,34.69,83.83,14.6,16,110,126
2011-10-08 18:00:00,2,3,19.52,59.64,10.79,48,86,134
2011-10-08 19:00:00,2,2,19.04,51.08,35.84,24,16,40
2011-10-08 20:00:00,1,2,24.35,96.05,35.39,25,26,51
2011-10-08 21:00:00,3,4,21.67,49.68,29.86,4,107,111
2011-10-08 22:00:00,4,1,24.02,33.36,30.72,8,190,198
2011-10-08 23:00:00,3,1,31.22,41.92,30.19,43,125,168
2011-10-09 00:00:00,2,4,27.39,39.12,18.01,43,141,184
2011-10-09 01:00:00,2,4,19.91,59.9,46.87,23,153,176
2011-10-09 02:00:00,3,1,18.86,43.32,23.96,6,170,176
2011-10-09 03:00:00,1,3,24.19,61.28,1.02,19,128,147
2011-10-09 04:00:00,3,4,18.67,73.54,17.42,43,23,66
2011-10-09 05:00:00,3,3,18.73,82.18,6.51,40,147,187
2011-10-09 06:00:00,4,4,5.49,76.81,18.17,7,199,206
2011-10-09 07:00:00,4,4,10.22,36.45,30.41,18,7,25
2011-10-09 08:00:00,3,3,19.66,29.27,1.13,34,29,63
2011-10-09 09:00:00,3,3,29.68,63.4,43.51,42,125,167
2011-10-09 10:00:00,2,1,13.36,35.91,30.52,43,17,60
2011-10-09 11:00:00,4,4,20.68,26.79,14.77,24,76,100
2011-10-09 12:00:00,4,2,15.35,62.17,15.56,16,121,137
2011-10-09 13:00:00,2,2,8.14,46.14,23.28,38,125,163
2011-10-09 14:00:00,1,4,33.75,80.49,12.4,24,110,134
2011-10-09 15:00:00,4,4,30.64,45.14,0.22,34,82,116
2011-10-09 16:00:00,4,4,7.35,98.3,1.33,38,140,178
2011-10-09 17:00:00,1,3,26.59,80.68,17.89,38,175,213
2011-10-09 18:00:00,4,2,15.43,24.62,6.21,45,187,232
2011-10-09 19:00:00,4,2,34.85,60.71,1.12,1,153,154
2011-10-09 20:00:00,1,2,14.07,65.01,42.96,15,123,138
2011-10-09 21:00:00,1,4,12.16,75.62,13.71,41,136,177
2011-10-09 22:00:00,3,3,22.04,59.82,25.16,13,97,110
2011-10-09 23:00:00,2,4,30.05,58.68,8.97,28,52,80
2011-10-10 00:00:00,2,1,10.78,49.44,2.34,38,94,132
2011-10-10 01:00:00,1,1,26.28,41.72,37.24,1,121,122
2011-10-10 02:00:00,1,2,6.84,95.7,6.25,9,105,114
2011-10-10 03:00:00,4,4,32.57,45.41,1.29,1,70,71
2011-10-10 04:00:00,3,1,7.43,25.07,29.36,26,136,162
2011-10-10 05:00:00,3,1,32.43,33.38,0.67,12,103,115
2011-10-10 06:00:00,1,4,19.72,88.58,21.81,1,153,154
2011-10-10 07:00:00,4,3,18.44,66.93,14.44,41,114,155
2011-10-10 08:00:00,4,4,34.2,82.3,15.97,13,160,173
2011-10-10 09:00:00,2,4,34.71,84.7,0.19,16,160,176
2011-10-10 10:00:00,2,3,24.51,85.86,48.22,43,120,163
2011-10-10 11:00:00,4,2,8.81,64.05,25.85,48,179,227
2011-10-10 12:00:00,2,2,20.19,34.17,28.63,37,167,204
2011-10-10 13:00:00,1,2,20.87,31.86,33.31,35,131,166
2011-10-10 14:00:00,4,3,20.43,65.92,39.88,33,155,188
2011-10-10 15:00:00,2,1,22.08,49.32,30.4,28,53,81
2011-10-10 16:00:00,3,3,5.56,64.64,38.11,46,195,241
2011-10-10 17:00:00,4,4,26.34,59.88,22.44,22,97,119
2011-10-10 18:00:00,4,3,26.37,68.18,18.56,22,48,70
2011-10-10 19:00:00,3,1,8.46,22.57,41.16,15,103,118
2011-10-10 20:00:00,1,1,22.11,22.63,43.27,43,111,154
2011-10-10 21:00:00,3,4,22.05,77.73,6.89,6,133,139
2011-10-10 22:00:00,4,2,25.47,35.45,27.13,44,32,76
2011-10-10 23:00:00,1,1,7.56,72.18,34.18,0,132,132
2011-10-11 00:00:00,2,1,23.8,63.73,4.18,18,145,163
2011-10-11 01:00:00,2,1,13.42,98.54,46.48,44,130,174
2011-10-11 02:00:00,2,4,20.21,86.83,26.01,32,97,129
2011-10-11 03:00:00,4,1,28.2,53.05,32.27,33,121,154
2011-10-11 04:00:00,3,2,26.17,69.31,8.91,0,1,1
2011-10-11 05:00:00,1,4,8.57,29.38,13.22,11,64,75
2011-10-11 06:00:00,2,2,22.74,50.91,6.05,24,34,58
2011-10-11 07:00:00,1,1,34.07,78.71,13.2,22,178,200
2011-10-11 08:00:00,4,1,9.7,69.81,24.62,24,67,91
2011-10-11 09:00:00,2,2,30.59,58.76,41.68,30,34,64
2011-10-11 10:00:00,4,4,26.08,34.12,26.69,23,71,94
2011-10-11 11:00:00,3,4,28.22,84.25,12.22,9,171,180
2011-10-11 12:00:00,4,2,13.46,41.85,2.23,1,28,29
2011-10-11 13:00:00,4,1,13.64,85.64,31.1,32,163,195
2011-10-11 14:00:00,3,3,32.18,68.93,21.01,36,77,113
2011-10-11 15:00:00,1,2,15.79,49.82,49.22,22,41,63
2011-10-11 16:00:00,3,2,6.89,23.25,38.99,1,112,113
2011-10-11 17:00:00,3,2,23.02,38.59,40.42,3,93,96
2011-10-11 18:00:00,4,1,8.74,91.13,0.61,22,113,135
2011-10-11 19:00:00,1,4,28.9,85.44,38.89,45,6,51
2011-10-11 20:00:00,2,1,24.25,65.99,9.73,40,140,180
2011-10-11 21:00:00,3,2,31.24,57.31,29.29,37,21,58
2011-10-11 22:00:00,1,1,28.55,71.77,22.37,22,56,78
2011-10-11 23:00:00,3,1,8.36,57.3,28.58,11,172,183
2011-10-12 00:00:00,3,2,16.43,71.54,6.67,43,181,224
2011-10-12 01:00:00,3,1,28.24,44.59,22.84,23,1,24
2011-10-12 02:00:00,3,3,17.52,87.08,1.85,28,199,227
2011-10-12 03:00:00,4,1,34.17,76.15,2.05,40,56,96
2011-10-12 04:00:00,1,1,27.07,46.4,32.89,27,117,144
2011-10-12 05:00:00,1,4,5.46,86.45,47.58,14,83,97
2011-10-12 06:00:00,1,4,31.4,58.99,38.87,9,74,83
2011-10-12 07:00:00,3,2,8.02,33.97,23.46,33,33,66
2011-10-12 08:00:00,4,2,9.22,26.22,2.79,28,43,71
2011-10-12 09:00:00,3,4,27.03,75.97,2.25,30,68,98
2011-10-12 10:00:00,3,3,30.95,89.21,7.89,22,52,74
2011-10-12 11:00:00,1,1,21.09,84.6,48.79,17,189,206
2011-10-12 12:00:00,3,3,13.67,72.45,19.93,6,93,99
2011-10-12 13:00:00,2,3,15.54,31.31,42.17,26,32,58
2011-10-12 14:00:00,3,4,15.29,27.52,35.26,8,75,83
2011-10-12 15:00:00,2,2,14.8,47.6,30.27,19,68,87
2011-10-12 16:00:00,3,1,12.29,88.39,47.39,20,128,148
2011-10-12 17:00:00,4,2,23.27,96.94,11.52,27,162,189
2011-10-12 18:00:00,4,3,32.01,39.31,22.74,49,24,73
2011-10-12 19:00:00,1,3,14.21,80.97,43.24,2,131,133
2011-10-12 20:00:00,3,2,10.6,65.91,27.59,44,72,116
2011-10-12 21:00:00,2,2,30.16,22.54,12.32,9,117,126
2011-10-12 22:00:00,2,4,27.25,63.43,10.45,16,112,128
2011-10-12 23:00:00,3,2,32.93,84.48,37.64,34,114,148
2011-10-13 00:00:00,2,2,9.97,42.09,0.64,20,124,144
2011-10-13 01:00:00,4,4,9.33,91.79,45.71,8,194,202
2011-10-13 02:00:00,2,2,21.24,38.9,0.92,16,93,109
2011-10-13 03:00:00,1,3,23.43,26.12,31.55,31,126,157
2011-10-13 04:00:00,4,2,19.41,32.8,30.24,47,137,184
2011-10-13 05:00:00,4,1,22.97,86.96,28.92,37,147,184
2011-10-13 06:00:00,4,3,10.41,53.38,23.72,27,39,66
2011-10-13 07:00:00,3,4,19.39,83.76,42.62,17,194,211
2011-10-13 08:00:00,3,3,24.74,62.5,32.97,5,74,79
2011-10-13 09:00:00,4,4,17.98,58.44,39.09,5,14,19
2011-10-13 10:00:00,3,1,25.38,84.55,5.78,16,115,131
2011-10-13 11:00:00,2,1,18.54,53.88,2.49,9,155,164
2011-10-13 12:00:00,3,3,15.01,84.16,1.43,1,107,108
2011-10-13 13:00:00,3,2,14.11,28.05,7.36,32,34,66
2011-10-13 14:00:00,4,3,17.33,70.9,33.35,42,6,48
2011-10-13 15:00:00,1,3,5.69,76.21,24.7,24,181,205
2011-10-13 16:00:00,1,1,25.06,91.93,37.61,37,169,206
2011-10-13 17:00:00,1,4,30.35,37.95,9.59,0,37,37
2011-10-13 18:00:00,2,3,15.64,68.34,18.35,15,63,78
2011-10-13 19:00:00,3,2,6.38,54.66,44.42,25,56,81
2011-10-13 20:00:00,1,1,34.6,50.62,46.79,40,107,147
2011-10-13 21:00:00,4,3,12.91,28.54,46.09,11,156,167
2011-10-13 22:00:00,1,3,8.8,30.74,40.92,8,123,131
2011-10-13 23:00:00,1,2,16.09,86.96,34.41,12,193,205
2011-10-14 00:00:00,3,3,27.16,79.98,45.68,6,82,88
2011-10-14 01:00:00,3,3,13.82,50.59,35.71,0,133,133
2011-10-14 02:00:00,3,3,22.24,86.28,47.7,30,80,110
2011-10-14 03:00:00,2,3,17.47,26.46,1.24,34,1,35
2011-10-14 04:00:00,2,2,8.53,69.98,46.08,23,166,189
2011-10-14 05:00:00,1,3,14.91,89.45,27.79,2,133,135
2011-10-14 06:00:00,3,3,26.75,87.11,5.59,18,13,31
2011-10-14 07:00:00,1,3,23.36,49.82,10.75,3,145,148
2011-10-14 08:00:00,4,1,8.59,79.62,42.61,27,69,96
2011-10-14 09:00:00,4,2,9.9,54.2,25.31,43,75,118
2011-10-14 10:00:00,3,1,24.22,87.21,49.14,29,149,178
2011-10-14 11:00:00,3,1,29.4,62.46,5.88,35,77,112
2011-10-14 12:00:00,4,2,15.48,81.19,20.63,41,12,53
2011-10-14 13:00:00,3,1,22.86,26.29,16.59,3,72,75
2011-10-14 14:00:00,2,1,10.12,67.2,25.81,22,113,135
2011-10-14 15:00:00,2,1,14.34,64.02,31.67,10,105,115
2011-10-14 16:00:00,3,2,5.61,68.8,33.08,3,9,12
2011-10-14 17:00:00,4,3,28.05,75.65,0.06,10,26,36
2011-10-14 18:00:00,1,4,17.03,93.45,4.45,48,13,61
2011-10-14 19:00:00,3,4,29.48,82.85,1.75,23,8,31
2011-10-14 20:00:00,3,2,26.25,37.57,43.23,19,136,155
2011-10-14 21:00:00,1,4,29.86,86.07,15.66,44,184,228
2011-10-14 22:00:00,3,2,13.57,29.77,18.35,16,104,120
2011-10-14 23:00:00,1,2,10.55,69.78,22.52,12,34,46
2011-10-15 00:00:00,4,4,34.16,90.62,42.47,16,153,169
2011-10-15 01:00:00,2,1,26.52,28.09,0.71,14,168,182
2011-10-15 02:00:00,4,3,30.02,87.98,5.93,3,108,111
2011-10-15 03:00:00,2,4,5.39,83.89,34.26,17,105,122
2011-10-15 04:00:00,1,4,15.63,60.3,48.19,42,120,162
2011-10-15 05:00:00,2,4,27.28,44.71,32.14,8,66,74
2011-10-15 06:00:00,4,4,7.34,52.44,13.06,47,29,76
2011-10-15 07:00:00,2,2,22.02,97.49,25.99,2,28,30
2011-10-15 08:00:00,1,2,17.87,36.14,48.75,26,83,109
2011-10-15 09:00:00,2,3,5.53,66.37,26.4,17,67,84
2011-10-15 10:00:00,3,3,12.08,26.66,18.68,16,13,29
2011-10-15 11:00:00,4,4,13.54,37.43,19.17,9,108,117
2011-10-15 12:00:00,3,4,8.36,81.07,48.35,36,179,215
2011-10-15 13:00:00,1,4,23.95,44.21,35.95,28,38,66
2011-10-15 14:00:00,2,3,12.27,98.86,34.36,46,20,66
2011-10-15 15:00:00,3,4,13.33,60.07,11.6,49,70,119
2011-10-15 16:00:00,3,1,31.95,61.32,27.97,4,5,9
2011-10-15 17:00:00,2,3,19.01,22.91,17.84,46,182,228
2011-10-15 18:00:00,2,1,16.76,96.52,12.01,5,39,44
2011-10-15 19:00:00,4,4,26.72,33.94,44.78,39,197,236
2011-10-15 20:00:00,3,2,32.29,63.07,19.16,34,152,186
2011-10-15 21:00:00,3,1,5.75,51.65,14.14,4,131,135
2011-10-15 22:00:00,1,3,18.45,53.25,46.59,49,161,210
2011-10-15 23:00:00,4,1,23.32,71.46,9.87,14,88,102
2011-10-16 00:00:00,1,3,14.56,72.97,37.28,26,21,47
2011-10-16 01:00:00,3,4,28.17,32.34,32.64,43,55,98
2011-10-16 02:00:00,1,1,34.14,59.97,46.02,38,45,83
2011-10-16 03:00:00,3,2,33.3,83.24,41.6,32,119,151
2011-10-16 04:00:00,3,1,12.98,55.46,35.26,23,183,206
2011-10-16 05:00:00,1,2,11.79,33.26,15.73,20,154,174
2011-10-16 06:00:00,1,3,33.72,45.06,24.78,1,89,90
2011-10-16 07:00:00,2,4,18.76,36.99,47.22,18,115,133
2011-10-16 08:00:00,2,4,11.25,30.07,1.16,44,162,206
2011-10-16 09:00:00,2,2,26.21,50.21,39.72,17,143,160
2011-10-16 10:00:00,3,3,13.53,63.27,12.59,9,103,112
2011-10-16 11:00:00,1,4,13.02,25.82,9.25,44,147,191
2011-10-16 12:00:00,4,3,31.38,68.31,11.61,36,14,50
2011-10-16 13:00:00,3,2,9.87,99.44,2.99,22,109,131
2011-10-16 14:00:00,4,2,6.93,97.13,49.6,44,199,243
2011-10-16 15:00:00,1,1,13.08,86.33,43.49,40,23,63
2011-10-16 16:00:00,3,4,23.21,41.31,26.05,0,189,189
2011-10-16 17:00:00,4,4,8.69,21.79,35.76,5,79,84
2011-10-16 18:00:00,4,1,19.15,86.68,27.83,0,43,43
2011-10-16 19:00:00,2,2,23.82,24.46,40.58,17,141,158
2011-10-16 20:00:00,2,2,30.46,36.45,42.24,26,72,98
2011-10-16 21:00:00,2,2,11.9,63.56,11.64,47,109,156
2011-10-16 22:00:00,3,2,29.52,34.27,22.99,39,178,217
2011-10-16 23:00:00,1,3,12.05,86.7,31.74,37,149,186
2011-10-17 00:00:00,1,4,25.3,82.17,48.92,44,159,203
2011-10-17 01:00:00,2,4,17.92,80.46,34.13,16,79,95
2011-10-17 02:00:00,2,2,8.44,85.29,44.88,25,114,139
2011-10-17 03:00:00,2,2,26.43,37.58,42.31,12,24,36
2011-10-17 04:00:00,4,2,11.53,78.31,29.1,9,176,185
2011-10-17 05:00:00,2,4,10.3,48.42,44.68,37,22,59
2011-10-17 06:00:00,4,4,15.75,73.35,18.87,25,36,61
2011-10-17 07:00:00,1,2,24.6,29.76,18.96,30,2,32
2011-10-17 08:00:00,3,3,12.02,76.45,39.05,22,59,81
2011-10-17 09:00:00,3,1,10.51,97.77,6.73,49,58,107
2011-10-17 10:00:00,3,1,5.3,23.49,15.29,19,150,169
2011-10-17 11:00:00,3,1,19.15,27.51,30.43,22,32,54
2011-10-17 12:00:00,4,4,17.86,29.89,21.0,44,181,225
2011-10-17 13:00:00,4,4,12.02,54.45,47.04,26,38,64
2011-10-17 14:00:00,2,1,6.61,43.26,47.93,14,152,166
2011-10-17 15:00:00,4,1,17.88,84.55,25.13,37,62,99
2011-10-17 16:00:00,2,3,28.65,57.9,26.95,10,88,98
2011-10-17 17:00:00,2,4,26.46,58.76,36.23,7,102,109
2011-10-17 18:00:00,3,4,30.82,77.36,22.86,13,84,97
2011-10-17 19:00:00,4,1,5.29,48.96,9.5,12,186,198
2011-10-17 20:00:00,4,3,33.99,48.26,37.35,21,158,179
2011-10-17 21:00:00,2,3,15.24,80.55,36.89,33,48,81
2011-10-17 22:00:00,2,1,34.71,82.4,12.25,0,102,102
2011-10-17 23:00:00,1,1,12.58,21.15,41.65,36,187,223
2011-10-18 00:00:00,1,4,19.15,31.5,30.68,31,108,139
2011-10-18 01:00:00,2,1,15.62,37.05,11.82,10,191,201
2011-10-18 02:00:00,1,2,15.67,48.13,32.6,9,165,174
2011-10-18 03:00:00,1,3,30.27,43.32,11.68,29,70,99
2011-10-18 04:00:00,2,1,27.39,73.48,13.26,11,90,101
2011-10-18 05:00:00,2,2,34.76,86.25,42.4,41,76,117
2011-10-18 06:00:00,4,3,23.41,35.37,46.47,40,86,126
2011-10-18 07:00:00,2,2,18.9,65.04,12.84,33,7,40
2011-10-18 08:00:00,2,2,7.7,49.43,46.4,24,12,36
2011-10-18 09:00:00,3,1,34.9,60.46,11.94,35,25,60
2011-10-18 10:00:00,4,3,21.55,69.66,5.86,3,137,140
2011-10-18 11:00:00,4,2,26.01,91.49,2.91,20,90,110
2011-10-18 12:00:00,4,4,17.2,35.38,12.11,29,55,84
2011-10-18 13:00:00,3,3,21.43,26.96,19.26,37,131,168
2011-10-18 14:00:00,2,4,33.28,70.18,46.38,11,105,116
2011-10-18 15:00:00,4,1,9.99,51.53,12.11,38,30,68
2011-10-18 16:00:00,4,4,13.77,33.03,18.27,24,16,40
2011-10-18 17:00:00,1,3,9.56,29.37,36.71,18,135,153
2011-10-18 18:00:00,4,2,28.77,64.71,15.1,1,179,180
2011-10-18 19:00:00,2,2,6.86,44.04,34.22,21,36,57
2011-10-18 20:00:00,2,3,7.45,99.79,21.6,29,124,153
2011-10-18 21:00:00,1,2,13.95,52.47,9.82,35,147,182
2011-10-18 22:00:00,4,4,20.43,36.98,36.7,2,46,48
2011-10-18 23:00:00,4,2,17.19,70.31,1.35,22,50,72
2011-10-19 00:00:00,4,2,6.34,39.54,14.62,3,113,116
2011-10-19 01:00:00,3,4,33.72,59.53,17.81,27,57,84
2011-10-19 02:00:00,4,4,33.59,58.61,22.91,13,43,56
2011-10-19 03:00:00,2,4,13.38,56.28,33.99,5,97,102
2011-10-19 04:00:00,2,1,26.95,83.69,22.97,5,10,15
2011-10-19 05:00:00,3,4,22.36,37.33,29.72,40,11,51
2011-10-19 06:00:00,3,4,12.12,92.34,29.79,36,137,173
2011-10-19 07:00:00,4,1,12.87,83.31,18.66,6,53,59
2011-10-19 08:00:00,1,2,19.73,46.65,46.7,12,33,45
2011-10-19 09:00:00,3,4,17.58,34.45,47.79,0,157,157
2011-10-19 10:00:00,3,3,13.74,42.36,29.09,23,142,165
2011-10-19 11:00:00,4,4,29.23,46.61,3.58,33,135,168
2011-10-19 12:00:00,4,4,19.44,64.55,24.56,9,99,108
2011-10-19 13:00:00,3,1,24.65,23.71,9.22,5,167,172
2011-10-19 14:00:00,1,3,10.68,93.15,24.16,3,21,24
2011-10-19 15:00:00,3,2,21.01,27.89,9.42,7,4,11
2011-10-19 16:00:00,4,2,14.54,42.34,35.19,45,19,64
2011-10-19 17:00:00,4,3,20.79,28.74,4.02,47,117,164
2011-10-19 18:00:00,3,4,28.42,40.53,47.67,14,48,62
2011-10-19 19:00:00,1,1,28.07,87.01,9.77,44,118,162
2011-10-19 20:00:00,3,3,15.63,69.21,33.03,11,179,190
2011-10-19 21:00:00,3,3,25.83,38.19,45.85,38,193,231
2011-10-19 22:00:00,4,2,33.24,89.74,12.39,46,146,192
2011-10-19 23:00:00,1,1,23.77,84.06,46.71,5,141,146
2011-10-20 00:00:00,2,3,9.45,80.29,19.43,20,6,26
2011-10-20 01:00:00,1,1,25.39,87.81,48.03,45,184,229
2011-10-20 02:00:00,3,4,8.15,69.57,48.57,31,79,110
2011-10-20 03:00:00,3,2,31.16,60.11,9.4,31,9,40
2011-10-20 04:00:00,3,4,20.5,49.91,41.55,26,106,132
2011-10-20 05:00:00,1,1,16.55,37.9,9.67,46,149,195
2011-10-20 06:00:00,4,4,6.71,64.59,11.32,10,132,142
2011-10-20 07:00:00,3,2,16.42,91.16,4.21,21,23,44
2011-10-20 08:00:00,3,1,32.1,67.52,7.83,35,142,177
2011-10-20 09:00:00,1,3,5.63,93.57,31.61,22,87,109
2011-10-20 10:00:00,2,4,19.24,48.55,22.46,36,153,189
2011-10-20 11:00:00,2,2,32.93,75.61,39.55,22,54,76
2011-10-20 12:00:00,4,3,16.85,71.89,16.6,26,97,123
2011-10-20 13:00:00,4,2,17.85,73.63,48.43,33,145,178
2011-10-20 14:00:00,3,1,22.36,71.6,2.49,19,170,189
2011-10-20 15:00:00,1,1,18.89,37.73,3.15,14,133,147
2011-10-20 16:00:00,3,4,10.06,31.49,35.07,41,172,213
2011-10-20 17:00:00,4,2,5.56,98.29,44.38,3,24,27
2011-10-20 18:00:00,1,2,23.29,23.62,39.78,28,143,171
2011-10-20 19:00:00,1,2,32.62,57.42,24.49,39,182,221
2011-10-20 20:00:00,4,1,8.19,54.01,13.48,10,183,193
2011-10-20 21:00:00,2,4,11.33,48.8,0.67,48,28,76
2011-10-20 22:00:00,2,2,16.11,82.56,25.47,6,63,69
2011-10-20 23:00:00,1,2,29.26,79.63,23.78,10,128,138
2011-10-21 00:00:00,3,3,13.08,92.42,17.21,41,123,164
2011-10-21 01:00:00,2,2,31.46,51.64,28.9,32,172,204
2011-10-21 02:00:00,3,4,6.65,65.13,36.44,29,108,137
2011-10-21 03:00:00,2,3,33.23,91.38,35.04,31,25,56
2011-10-21 04:00:00,2,3,21.82,99.51,13.16,39,84,123
2011-10-21 05:00:00,3,3,24.76,97.54,29.27,36,49,85
2011-10-21 06:00:00,4,1,16.03,77.43,7.44,12,154,166
2011-10-21 07:00:00,2,3,28.46,31.46,6.08,6,99,105
2011-10-21 08:00:00,2,2,10.0,21.85,39.29,23,162,185
2011-10-21 09:00:00,3,1,6.47,86.02,34.69,10,79,89
2011-10-21 10:00:00,4,1,16.87,87.28,38.4,30,28,58
2011-10-21 11:00:00,2,1,30.61,79.71,7.62,43,134,177
2011-10-21 12:00:00,2,1,27.65,42.39,45.73,13,61,74
2011-10-21 13:00:00,4,1,20.51,71.19,6.66,43,70,113
2011-10-21 14:00:00,2,1,22.16,45.3,43.5,25,126,151
2011-10-21 15:00:00,4,1,8.9,56.05,17.62,0,33,33
2011-10-21 16:00:00,4,3,30.22,50.59,5.27,5,175,180
2011-10-21 17:00:00,3,4,28.61,93.09,14.34,30,132,162
2011-10-21 18:00:00,1,2,24.69,38.73,9.07,42,116,158
2011-10-21 19:00:00,4,2,18.99,66.21,24.53,42,7,49
2011-10-21 20:00:00,3,3,33.93,48.88,47.49,11,199,210
2011-10-21 21:00:00,1,3,31.37,73.05,16.39,0,42,42
2011-10-21 22:00:00,2,1,24.33,65.17,30.6,5,179,184
2011-10-21 23:00:00,1,4,16.15,93.92,44.59,28,73,101
2011-10-22 00:00:00,4,1,23.54,28.13,31.5,29,0,29
2011-10-22 01:00:00,4,3,22.26,37.65,18.11,12,37,49
2011-10-22 02:00:00,4,1,16.83,81.31,49.54,29,6,35
2011-10-22 03:00:00,4,2,14.2,49.5,9.37,11,80,91
2011-10-22 04:00:00,4,2,17.21,33.26,26.16,9,183,192
2011-10-22 05:00:00,3,1,22.22,60.27,39.84,38,173,211
2011-10-22 06:00:00,4,4,17.84,72.17,0.03,9,23,32
2011-10-22 07:00:00,3,1,12.91,23.59,35.1,17,34,51
2011-10-22 08:00:00,2,1,27.83,43.33,13.32,5,41,46
2011-10-22 09:00:00,4,4,20.94,84.75,8.49,7,194,201
2011-10-22 10:00:00,4,4,7.03,61.62,13.71,19,43,62
2011-10-22 11:00:00,1,4,16.05,22.83,48.34,40,3,43
2011-10-22 12:00:00,2,2,31.55,42.56,44.6,15,107,122
2011-10-22 13:00:00,4,1,27.66,71.13,10.69,1,118,119
2011-10-22 14:00:00,4,3,14.7,35.95,5.85,10,76,86
2011-10-22 15:00:00,2,4,33.15,86.19,18.21,23,23,46
2011-10-22 16:00:00,3,4,7.3,74.13,29.62,18,70,88
2011-10-22 17:00:00,4,1,33.84,57.71,43.36,3,146,149
2011-10-22 18:00:00,1,3,12.37,93.25,48.3,2,122,124
2011-10-22 19:00:00,4,1,5.27,51.34,37.56,14,90,104
2011-10-22 20:00:00,1,1,18.01,38.81,29.95,39,177,216
2011-10-22 21:00:00,1,4,15.77,72.91,7.12,3,145,148
2011-10-22 22:00:00,4,4,21.17,65.86,3.7,42,93,135
2011-10-22 23:00:00,4,2,28.9,46.82,29.8,16,155,171
2011-10-23 00:00:00,1,3,30.27,47.49,26.95,8,156,164
2011-10-23 01:00:00,2,3,17.04,51.86,42.3,24,72,96
2011-10-23 02:00:00,2,4,17.9,43.29,16.13,0,102,102
2011-10-23 03:00:00,4,4,9.45,76.82,1.98,39,102,141
2011-10-23 04:00:00,3,4,6.43,72.11,21.19,1,84,85
2011-10-23 05:00:00,2,3,24.24,55.26,48.46,44,172,216
2011-10-23 06:00:00,4,2,6.93,51.83,39.78,32,101,133
2011-10-23 07:00:00,2,3,27.01,49.2,1.69,21,134,155
2011-10-23 08:00:00,3,4,21.17,42.68,43.73,41,44,85
2011-10-23 09:00:00,4,4,10.96,26.86,23.58,11,88,99
2011-10-23 10:00:00,3,2,21.19,41.46,18.24,26,153,179
2011-10-23 11:00:00,4,1,10.49,45.7,17.34,10,69,79
2011-10-23 12:00:00,3,1,18.16,63.81,29.76,41,48,89
2011-10-23 13:00:00,2,3,28.99,81.9,26.53,13,118,131
2011-10-23 14:00:00,2,1,18.86,51.66,32.83,13,83,96
2011-10-23 15:00:00,3,1,9.46,95.58,28.68,39,145,184
2011-10-23 16:00:00,3,3,26.71,86.19,7.2,42,39,81
2011-10-23 17:00:00,3,4,10.6,98.78,12.86,21,17,38
2011-10-23 18:00:00,4,1,27.16,90.1,42.05,8,46,54
2011-10-23 19:00:00,2,4,19.38,69.34,33.16,14,0,14
2011-10-23 20:00:00,4,3,18.61,67.88,22.42,32,160,192
2011-10-23 21:00:00,2,4,30.54,30.36,9.13,18,38,56
2011-10-23 22:00:00,1,4,26.26,77.79,0.38,30,111,141
2011-10-23 23:00:00,4,3,5.99,68.02,15.59,17,22,39
2011-10-24 00:00:00,2,4,13.89,60.55,2.74,11,13,24
2011-10-24 01:00:00,2,1,31.13,75.46,24.11,39,171,210
2011-10-24 02:00:00,4,1,5.55,55.52,41.09,36,36,72
2011-10-24 03:00:00,4,1,21.36,61.91,14.27,44,70,114
2011-10-24 04:00:00,2,1,26.83,51.87,42.39,48,75,123
2011-10-24 05:00:00,4,4,23.66,77.39,35.23,0,164,164
2011-10-24 06:00:00,3,1,27.82,90.13,6.26,33,155,188
2011-10-24 07:00:00,4,4,26.77,87.27,32.23,6,122,128
2011-10-24 08:00:00,4,2,25.76,82.88,7.58,1,6,7
2011-10-24 09:00:00,4,4,29.65,21.1,32.74,21,108,129
2011-10-24 10:00:00,2,1,24.37,92.95,7.14,3,120,123
2011-10-24 11:00:00,3,2,17.07,41.99,19.63,44,179,223
2011-10-24 12:00:00,1,3,19.16,91.04,28.33,45,144,189
2011-10-24 13:00:00,1,4,26.5,35.76,2.52,19,189,208
2011-10-24 14:00:00,3,1,31.29,55.17,7.67,2,164,166
2011-10-24 15:00:00,3,1,13.17,79.95,16.02,8,13,21
2011-10-24 16:00:00,3,1,15.26,71.22,23.12,17,178,195
2011-10-24 17:00:00,2,3,32.92,53.27,42.92,15,54,69
2011-10-24 18:00:00,1,2,22.36,74.29,9.36,8,56,64
2011-10-24 19:00:00,3,2,10.37,63.92,17.37,18,3,21
2011-10-24 20:00:00,2,1,24.91,42.06,23.79,5,48,53
2011-10-24 21:00:00,1,4,34.72,71.71,14.79,43,80,123
2011-10-24 22:00:00,4,1,29.7,36.34,31.29,14,34,48
2011-10-24 23:00:00,2,1,27.37,75.52,12.83,5,109,114
2011-10-25 00:00:00,1,4,11.24,20.25,38.62,4,180,184
2011-10-25 01:00:00,2,1,31.28,63.9,25.26,28,159,187
2011-10-25 02:00:00,1,3,20.77,52.09,4.32,45,101,146
2011-10-25 03:00:00,1,1,31.68,44.25,31.35,26,120,146
2011-10-25 04:00:00,4,3,14.89,61.26,28.46,49,9,58
2011-10-25 05:00:00,2,1,6.86,71.62,16.93,44,112,156
2011-10-25 06:00:00,3,2,19.28,97.22,0.56,40,189,229
2011-10-25 07:00:00,4,4,13.1,86.65,10.04,25,1,26
2011-10-25 08:00:00,4,2,26.46,77.37,20.29,27,62,89
2011-10-25 09:00:00,1,1,33.71,58.32,10.0,31,119,150
2011-10-25 10:00:00,3,1,25.73,51.37,28.87,24,143,167
2011-10-25 11:00:00,2,3,31.61,22.6,35.62,6,15,21
2011-10-25 12:00:00,3,1,18.59,48.73,42.8,29,130,159
2011-10-25 13:00:00,3,1,28.15,87.87,32.35,30,17,47
2011-10-25 14:00:00,3,1,30.29,50.72,34.45,11,41,52
2011-10-25 15:00:00,3,2,26.33,56.93,30.42,8,159,167
2011-10-25 16:00:00,3,3,20.23,41.75,49.27,33,123,156
2011-10-25 17:00:00,1,2,23.78,41.93,13.05,2,49,51
2011-10-25 18:00:00,1,3,26.02,24.95,13.31,36,176,212
2011-10-25 19:00:00,4,2,12.59,69.1,6.32,49,2,51
2011-10-25 20:00:00,1,1,29.29,55.85,24.28,27,71,98
2011-10-25 21:00:00,4,2,33.51,68.48,4.81,45,115,160
2011-10-25 22:00:00,4,2,18.96,63.75,13.51,21,124,145
2011-10-25 23:00:00,2,3,26.03,83.91,24.13,25,126,151
2011-10-26 00:00:00,3,3,27.11,80.08,47.88,18,4,22
2011-10-26 01:00:00,1,2,24.87,81.72,48.19,20,184,204
2011-10-26 02:00:00,2,3,21.41,59.94,37.19,36,83,119
2011-10-26 03:00:00,1,3,31.45,48.31,19.46,9,171,180
2011-10-26 04:00:00,4,3,18.47,94.67,43.26,15,152,167
2011-10-26 05:00:00,1,4,6.83,24.34,43.77,23,197,220
2011-10-26 06:00:00,3,3,30.34,32.21,45.51,24,22,46
2011-10-26 07:00:00,4,4,25.22,53.57,32.0,25,137,162
2011-10-26 08:00:00,4,4,30.48,69.12,10.09,0,137,137
2011-10-26 09:00:00,2,3,9.16,20.66,4.55,3,160,163
2011-10-26 10:00:00,3,2,5.92,77.55,45.74,36,72,108
2011-10-26 11:00:00,4,3,33.03,64.7,2.78,42,145,187
2011-10-26 12:00:00,3,1,9.43,58.78,14.79,13,194,207
2011-10-26 13:00:00,1,2,29.29,53.88,24.35,23,96,119
2011-10-26 14:00:00,3,4,29.7,61.56,1.1,26,73,99
2011-10-26 15:00:00,4,4,26.26,32.94,45.35,42,26,68
2011-10-26 16:00:00,2,2,8.94,28.7,14.36,26,162,188
2011-10-26 17:00:00,4,2,25.02,43.17,1.43,23,61,84
2011-10-26 18:00:00,3,3,31.67,76.76,49.68,39,145,184
2011-10-26 19:00:00,3,4,17.77,67.06,15.57,0,6,6
2011-10-26 20:00:00,4,1,17.41,58.41,43.84,38,198,236
2011-10-26 21:00:00,3,3,18.29,65.72,22.67,12,9,21
2011-10-26 22:00:00,1,2,7.47,64.74,33.16,19,26,45
2011-10-26 23:00:00,4,4,31.76,44.56,12.05,37,67,104
2011-10-27 00:00:00,2,2,31.08,27.8,25.14,35,194,229
2011-10-27 01:00:00,4,2,34.94,91.74,12.88,11,182,193
2011-10-27 02:00:00,1,2,22.56,67.99,47.55,4,47,51
2011-10-27 03:00:00,1,3,27.54,75.82,3.05,4,106,110
2011-10-27 04:00:00,1,1,11.08,57.12,13.73,16,66,82
2011-10-27 05:00:00,1,1,25.03,80.52,44.66,37,88,125
2011-10-27 06:00:00,1,4,24.49,66.76,24.0,9,153,162
2011-10-27 07:00:00,2,2,32.04,24.3,30.0,15,167,182
2011-10-27 08:00:00,3,1,29.92,91.21,32.58,23,70,93
2011-10-27 09:00:00,1,2,33.15,44.44,3.55,28,45,73
2011-10-27 10:00:00,1,4,31.07,31.03,0.89,13,97,110
2011-10-27 11:00:00,4,2,31.06,27.04,46.89,9,194,203
2011-10-27 12:00:00,2,1,6.91,77.64,13.58,28,91,119
2011-10-27 13:00:00,2,2,30.38,76.32,19.02,27,10,37
2011-10-27 14:00:00,3,1,23.22,76.01,34.1,16,178,194
2011-10-27 15:00:00,2,4,16.41,93.26,11.82,4,31,35
2011-10-27 16:00:00,4,2,6.7,47.92,36.65,1,71,72
2011-10-27 17:00:00,4,1,25.33,64.89,22.91,35,147,182
2011-10-27 18:00:00,3,4,14.85,69.56,42.83,49,132,181
2011-10-27 19:00:00,4,2,19.03,98.36,13.93,39,125,164
2011-10-27 20:00:00,1,4,25.45,44.99,10.19,45,168,213
2011-10-27 21:00:00,1,1,32.35,96.51,41.58,44,12,56
2011-10-27 22:00:00,4,2,29.76,31.9,16.32,38,121,159
2011-10-27 23:00:00,3,2,18.52,81.12,20.59,8,97,105
2011-10-28 00:00:00,2,2,16.63,70.63,39.69,35,130,165
2011-10-28 01:00:00,3,4,12.19,85.35,31.78,4,142,146
2011-10-28 02:00:00,2,4,16.17,22.29,22.09,14,96,110
2011-10-28 03:00:00,4,1,8.33,26.25,12.49,8,55,63
2011-10-28 04:00:00,4,3,34.13,25.58,38.21,24,123,147
2011-10-28 05:00:00,1,2,22.22,67.44,9.02,49,170,219
2011-10-28 06:00:00,2,2,8.83,68.23,46.41,27,194,221
2011-10-28 07:00:00,3,1,15.58,92.49,7.52,26,45,71
2011-10-28 08:00:00,4,2,21.41,57.41,40.25,45,116,161
2011-10-28 09:00:00,3,4,20.99,25.44,21.21,46,175,221
2011-10-28 10:00:00,1,4,6.07,36.76,9.3,32,104,136
2011-10-28 11:00:00,2,2,33.53,20.65,20.12,32,96,128
2011-10-28 12:00:00,2,2,13.26,82.14,11.08,37,163,200
2011-10-28 13:00:00,4,4,5.49,85.25,6.8,7,150,157
2011-10-28 14:00:00,2,2,7.29,99.84,11.96,3,182,185
2011-10-28 15:00:00,4,4,22.41,52.98,43.37,47,54,101
2011-10-28 16:00:00,1,3,9.13,21.54,5.3,42,53,95
2011-10-28 17:00:00,2,3,6.25,38.78,48.63,35,124,159
2011-10-28 18:00:00,4,2,16.39,67.02,0.25,42,64,106
2011-10-28 19:00:00,3,2,23.68,96.96,32.91,30,50,80
2011-10-28 20:00:00,4,2,8.36,28.29,42.83,9,159,168
2011-10-28 21:00:00,2,4,14.4,29.73,46.7,48,127,175
2011-10-28 22:00:00,1,3,17.53,76.14,7.2,40,147,187
2011-10-28 23:00:00,2,3,9.78,73.38,34.91,41,90,131
2011-10-29 00:00:00,2,1,20.18,40.04,5.37,7,163,170
2011-10-29 01:00:00,4,1,7.56,85.05,17.63,29,31,60
2011-10-29 02:00:00,3,2,6.4,30.3,36.6,13,102,115
2011-10-29 03:00:00,2,4,20.6,94.06,17.3,44,56,100
2011-10-29 04:00:00,3,2,12.44,36.08,15.67,34,28,62
2011-10-29 05:00:00,4,3,7.86,26.51,5.8,45,173,218
2011-10-29 06:00:00,3,2,17.72,47.16,3.32,45,86,131
2011-10-29 07:00:00,4,2,32.45,35.03,5.76,2,121,123
2011-10-29 08:00:00,1,3,26.73,62.16,43.77,28,162,190
2011-10-29 09:00:00,3,3,29.47,74.95,0.56,15,78,93
2011-10-29 10:00:00,3,3,31.16,59.27,34.64,9,106,115
2011-10-29 11:00:00,1,3,34.18,72.85,38.43,3,51,54
2011-10-29 12:00:00,3,1,27.9,49.19,28.39,49,142,191
2011-10-29 13:00:00,1,4,23.25,22.23,36.54,3,88,91
2011-10-29 14:00:00,2,4,15.96,97.93,32.61,1,178,179
2011-10-29 15:00:00,4,3,10.45,85.55,22.78,10,30,40
2011-10-29 16:00:00,1,4,25.6,25.87,19.14,14,83,97
2011-10-29 17:00:00,3,4,34.85,55.93,47.07,10,143,153
2011-10-29 18:00:00,1,4,19.02,70.8,48.6,22,163,185
2011-10-29 19:00:00,3,4,26.71,35.25,32.56,37,38,75
2011-10-29 20:00:00,2,3,19.85,66.24,9.86,49,138,187
2011-10-29 21:00:00,1,2,17.96,62.69,22.39,29,147,176
2011-10-29 22:00:00,2,2,17.31,36.66,24.83,49,55,104
2011-10-29 23:00:00,4,2,20.14,31.3,37.9,0,169,169
2011-10-30 00:00:00,3,1,16.01,80.72,33.39,44,46,90
2011-10-30 01:00:00,3,4,27.46,45.81,25.74,32,5,37
2011-10-30 02:00:00,2,3,31.23,39.52,34.02,44,108,152
2011-10-30 03:00:00,4,3,31.49,79.03,1.2,36,34,70
2011-10-30 04:00:00,1,1,11.83,78.89,38.83,22,135,157
2011-10-30 05:00:00,1,3,31.88,42.11,10.58,48,70,118
2011-10-30 06:00:00,3,2,15.25,89.81,32.82,47,36,83
2011-10-30 07:00:00,2,1,14.28,75.06,5.7,17,177,194
2011-10-30 08:00:00,2,3,26.8,47.66,5.72,9,122,131
2011-10-30 09:00:00,1,1,14.14,54.2,1.78,16,143,159
2011-10-30 10:00:00,4,1,6.59,78.14,45.51,6,8,14
2011-10-30 11:00:00,4,3,16.21,36.93,30.23,14,74,88
2011-10-30 12:00:00,1,2,26.64,57.5,18.1,26,59,85
2011-10-30 13:00:00,1,3,14.81,72.28,39.39,8,50,58
2011-10-30 14:00:00,2,4,23.89,63.16,31.3,20,45,65
2011-10-30 15:00:00,4,4,24.8,68.67,31.0,36,70,106
2011-10-30 16:00:00,1,3,27.01,63.7,24.35,28,139,167
2011-10-30 17:00:00,1,2,31.91,35.94,0.4,41,63,104
2011-10-30 18:00:00,3,4,17.98,52.82,12.92,44,114,158
2011-10-30 19:00:00,1,4,9.99,62.56,5.45,32,20,52
2011-10-30 20:00:00,1,3,14.57,82.41,33.12,5,4,9
2011-10-30 21:00:00,4,3,17.97,72.31,12.43,24,5,29
2011-10-30 22:00:00,2,3,26.42,54.13,22.51,34,42,76
2011-10-30 23:00:00,4,1,5.39,97.95,17.67,16,25,41
2011-10-31 00:00:00,2,1,14.47,28.62,7.16,43,92,135
2011-10-31 01:00:00,3,1,28.4,36.54,47.92,26,53,79
2011-10-31 02:00:00,1,3,25.13,47.31,46.67,42,127,169
2011-10-31 03:00:00,3,2,26.95,38.29,4.23,39,130,169
2011-10-31 04:00:00,2,4,29.35,70.04,41.37,24,138,162
2011-10-31 05:00:00,4,1,28.5,23.16,24.42,11,24,35
2011-10-31 06:00:00,4,2,25.47,34.19,38.69,42,139,181
2011-10-31 07:00:00,3,3,18.19,43.47,7.56,36,64,100
2011-10-31 08:00:00,2,1,34.51,74.67,6.61,39,3,42
2011-10-31 09:00:00,3,3,22.07,90.07,44.54,43,179,222
2011-10-31 10:00:00,3,2,11.08,83.88,44.89,37,126,163
2011-10-31 11:00:00,1,1,13.78,34.57,23.3,40,192,232
2011-10-31 12:00:00,3,1,25.81,65.23,43.51,24,197,221
2011-10-31 13:00:00,1,1,32.74,22.4,33.37,48,161,209
2011-10-31 14:00:00,1,1,10.36,44.84,9.25,1,108,109
2011-10-31 15:00:00,4,2,7.47,84.48,16.45,0,15,15
2011-10-31 16:00:00,1,1,31.45,56.53,6.8,49,141,190
2011-10-31 17:00:00,1,4,32.46,32.0,38.7,2,101,103
2011-10-31 18:00:00,4,4,13.29,55.08,49.26,28,112,140
2011-10-31 19:00:00,3,3,16.32,35.84,27.32,13,73,86
2011-10-31 20:00:00,2,1,24.81,51.46,32.79,44,188,232
2011-10-31 21:00:00,2,4,14.9,59.03,37.3,33,52,85
2011-10-31 22:00:00,2,4,31.31,47.96,11.21,21,117,138
2011-10-31 23:00:00,3,4,8.23,94.96,16.8,35,185,220
2011-11-01 00:00:00,1,2,6.14,65.0,20.62,14,62,76
2011-11-01 01:00:00,2,1,11.25,87.43,29.73,36,140,176
2011-11-01 02:00:00,3,2,13.58,80.86,42.52,9,44,53
2011-11-01 03:00:00,1,2,8.39,72.89,12.71,8,182,190
2011-11-01 04:00:00,4,4,6.97,59.75,23.54,49,160,209
2011-11-01 05:00:00,2,4,27.67,20.17,37.58,34,61,95
2011-11-01 06:00:00,1,3,9.93,69.08,4.37,45,166,211
2011-11-01 07:00:00,2,1,32.42,48.48,25.64,41,140,181
2011-11-01 08:00:00,2,1,16.04,29.42,7.22,16,80,96
2011-11-01 09:00:00,2,4,25.12,55.57,26.96,46,72,118
2011-11-01 10:00:00,1,4,11.76,78.84,38.39,17,140,157
2011-11-01 11:00:00,3,1,12.21,96.93,11.85,48,15,63
2011-11-01 12:00:00,1,3,22.24,49.93,42.47,24,181,205
2011-11-01 13:00:00,2,4,21.82,63.42,16.74,34,157,191
2011-11-01 14:00:00,1,3,28.06,88.1,9.54,15,166,181
2011-11-01 15:00:00,4,2,27.73,46.72,23.27,44,96,140
2011-11-01 16:00:00,3,4,25.12,31.38,43.8,48,103,151
2011-11-01 17:00:00,1,2,18.47,42.55,3.45,24,63,87
2011-11-01 18:00:00,4,4,31.72,91.93,16.38,15,69,84
2011-11-01 19:00:00,3,2,23.68,32.75,32.66,40,139,179
2011-11-01 20:00:00,4,4,34.71,46.34,17.88,23,129,152
2011-11-01 21:00:00,3,3,29.58,57.17,3.54,11,160,171
2011-11-01 22:00:00,1,3,6.33,87.77,16.6,34,142,176
2011-11-01 23:00:00,4,3,14.62,95.02,41.05,8,80,88
2011-11-02 00:00:00,2,2,22.16,54.06,48.4,47,179,226
2011-11-02 01:00:00,4,3,26.64,94.56,1.99,36,162,198
2011-11-02 02:00:00,3,2,21.51,32.92,28.46,31,94,125
2011-11-02 03:00:00,1,4,28.58,32.55,5.27,18,122,140
2011-11-02 04:00:00,3,2,13.48,95.94,34.02,21,37,58
2011-11-02 05:00:00,4,4,10.52,60.77,0.39,44,41,85
2011-11-02 06:00:00,4,1,6.62,34.87,0.74,33,108,141
2011-11-02 07:00:00,2,1,22.2,59.04,38.84,18,80,98
2011-11-02 08:00:00,1,1,25.66,82.66,3.72,49,6,55
2011-11-02 09:00:00,1,2,14.78,86.15,15.26,11,55,66
2011-11-02 10:00:00,4,1,23.41,89.12,47.9,17,132,149
2011-11-02 11:00:00,1,1,6.56,65.57,49.26,4,167,171
2011-11-02 12:00:00,2,1,7.98,89.36,8.07,25,60,85
2011-11-02 13:00:00,3,4,26.05,60.8,28.05,26,64,90
2011-11-02 14:00:00,1,3,16.04,68.56,27.96,19,193,212
2011-11-02 15:00:00,4,2,25.14,80.7,22.62,7,195,202
2011-11-02 16:00:00,3,1,29.95,54.03,46.24,15,192,207
2011-11-02 17:00:00,3,4,30.58,25.89,37.7,1,92,93
2011-11-02 18:00:00,2,3,10.17,48.01,38.23,44,84,128
2011-11-02 19:00:00,4,3,19.59,69.92,13.48,0,169,169
2011-11-02 20:00:00,1,3,27.02,35.39,21.72,4,162,166
2011-11-02 21:00:00,4,4,28.22,31.87,24.37,30,193,223
2011-11-02 22:00:00,3,1,28.54,43.45,14.95,22,24,46
2011-11-02 23:00:00,4,3,11.85,22.57,4.74,20,5,25
2011-11-03 00:00:00,1,4,10.78,79.47,6.32,11,7,18
2011-11-03 01:00:00,1,4,22.7,40.7,9.03,3,162,165
2011-11-03 02:00:00,2,2,27.23,29.94,10.18,36,52,88
2011-11-03 03:00:00,1,4,14.57,75.93,12.11,10,18,28
2011-11-03 04:00:00,1,3,8.14,87.43,12.77,41,8,49
2011-11-03 05:00:00,4,3,26.5,21.59,22.79,39,160,199
2011-11-03 06:00:00,4,4,13.99,38.69,25.48,8,7,15
2011-11-03 07:00:00,3,3,9.99,95.62,15.44,25,37,62
2011-11-03 08:00:00,2,4,9.43,50.82,45.36,38,159,197
2011-11-03 09:00:00,4,3,14.45,95.09,27.66,26,22,48
2011-11-03 10:00:00,1,2,22.78,41.94,39.37,28,161,189
2011-11-03 11:00:00,3,1,15.75,37.45,46.21,45,86,131
2011-11-03 12:00:00,4,2,5.62,37.13,8.16,42,173,215
2011-11-03 13:00:00,2,2,7.91,26.82,21.39,49,159,208
2011-11-03 14:00:00,2,1,13.72,91.71,21.66,24,128,152
2011-11-03 15:00:00,3,3,24.79,98.39,17.72,17,6,23
2011-11-03 16:00:00,3,1,7.96,96.36,0.45,29,106,135
2011-11-03 17:00:00,3,4,21.82,88.16,40.8,7,111,118
2011-11-03 18:00:00,3,1,8.6,87.75,5.58,1,23,24
2011-11-03 19:00:00,3,2,11.35,72.89,49.77,21,129,150
2011-11-03 20:00:00,1,1,10.17,86.1,38.65,20,145,165
2011-11-03 21:00:00,1,3,7.02,36.67,29.0,38,82,120
2011-11-03 22:00:00,4,2,25.14,51.03,7.73,25,105,130
2011-11-03 23:00:00,2,4,18.9,71.27,25.77,28,99,127
2011-11-04 00:00:00,1,3,29.93,89.98,13.06,4,55,59
2011-11-04 01:00:00,1,2,7.97,72.84,12.62,45,91,136
2011-11-04 02:00:00,1,4,9.34,87.12,41.48,13,31,44
2011-11-04 03:00:00,4,3,14.19,57.92,19.03,34,76,110
2011-11-04 04:00:00,3,4,27.98,77.38,22.54,5,69,74
2011-11-04 05:00:00,4,1,14.17,98.4,42.15,22,92,114
2011-11-04 06:00:00,2,1,17.25,32.28,4.39,16,9,25
2011-11-04 07:00:00,2,4,14.05,94.15,29.73,23,122,145
2011-11-04 08:00:00,2,1,7.41,61.79,28.91,39,167,206
2011-11-04 09:00:00,2,4,33.18,71.46,21.26,28,73,101
2011-11-04 10:00:00,1,3,21.46,90.23,41.49,29,33,62
2011-11-04 11:00:00,1,2,28.63,52.77,47.14,23,83,106
2011-11-04 12:00:00,4,4,24.75,53.5,23.27,34,110,144
2011-11-04 13:00:00,3,2,20.43,62.17,22.81,46,32,78
2011-11-04 14:00:00,2,2,7.69,21.53,25.1,36,87,123
2011-11-04 15:00:00,4,4,24.28,59.73,36.16,1,96,97
2011-11-04 16:00:00,1,1,9.66,43.29,33.4,20,56,76
2011-11-04 17:00:00,1,3,17.43,94.24,11.14,39,149,188
2011-11-04 18:00:00,3,2,23.87,27.02,3.19,40,175,215
2011-11-04 19:00:00,3,3,28.47,56.75,47.46,4,31,35
2011-11-04 20:00:00,3,2,25.55,95.8,13.05,34,124,158
2011-11-04 21:00:00,4,4,25.15,92.08,31.93,43,107,150
2011-11-04 22:00:00,1,1,9.47,76.11,41.42,34,172,206
2011-11-04 23:00:00,1,3,15.38,67.15,15.01,18,1,19
2011-11-05 00:00:00,3,2,6.29,42.46,31.77,15,182,197
2011-11-05 01:00:00,2,4,26.58,49.36,5.4,24,58,82
2011-11-05 02:00:00,3,4,33.58,27.21,48.5,15,32,47
2011-11-05 03:00:00,4,2,12.92,82.89,2.91,30,95,125
2011-11-05 04:00:00,3,2,7.63,45.91,21.91,32,104,136
2011-11-05 05:00:00,3,2,19.27,73.42,26.84,16,13,29
2011-11-05 06:00:00,4,1,30.7,48.61,39.52,20,195,215
2011-11-05 07:00:00,3,2,21.56,57.15,6.06,34,193,227
2011-11-05 08:00:00,1,2,6.4,64.4,22.04,48,58,106
2011-11-05 09:00:00,2,1,34.23,84.15,14.99,22,14,36
2011-11-05 10:00:00,3,4,29.86,36.89,15.6,48,158,206
2011-11-05 11:00:00,4,2,8.95,51.9,38.94,15,28,43
2011-11-05 12:00:00,2,3,32.65,30.41,0.27,37,111,148
2011-11-05 13:00:00,4,4,18.52,26.06,37.45,49,108,157
2011-11-05 14:00:00,2,3,16.16,68.37,40.52,13,122,135
2011-11-05 15:00:00,2,2,18.83,35.13,45.07,39,46,85
2011-11-05 16:00:00,3,1,30.04,24.78,31.34,40,184,224
2011-11-05 17:00:00,1,1,24.78,91.77,16.67,49,57,106
2011-11-05 18:00:00,3,1,6.78,62.75,21.36,32,92,124
2011-11-05 19:00:00,4,2,33.73,30.77,48.49,20,84,104
2011-11-05 20:00:00,4,2,9.43,24.27,44.06,16,158,174
2011-11-05 21:00:00,2,3,27.37,29.59,23.18,3,52,55
2011-11-05 22:00:00,2,1,24.08,57.71,47.15,15,85,100
2011-11-05 23:00:00,1,2,10.63,73.48,41.15,29,63,92
2011-11-06 00:00:00,3,4,10.12,71.3,45.05,43,81,124
2011-11-06 01:00:00,4,2,31.11,31.55,34.15,44,1,45
2011-11-06 02:00:00,2,2,17.59,70.68,42.88,33,59,92
2011-11-06 03:00:00,1,4,24.64,52.39,44.59,21,83,104
2011-11-06 04:00:00,4,1,20.12,57.18,4.6,43,175,218
2011-11-06 05:00:00,2,4,26.82,84.11,48.26,41,47,88
2011-11-06 06:00:00,4,1,19.38,46.6,16.68,28,117,145
2011-11-06 07:00:00,1,4,13.62,31.76,21.99,46,188,234
2011-11-06 08:00:00,1,3,15.9,89.88,39.6,4,131,135
2011-11-06 09:00:00,4,1,30.77,36.97,33.24,0,25,25
2011-11-06 10:00:00,3,2,19.04,43.52,44.65,39,83,122
2011-11-06 11:00:00,4,3,11.4,76.53,20.03,24,149,173
2011-11-06 12:00:00,2,1,33.04,74.68,18.66,49,170,219
2011-11-06 13:00:00,3,1,28.9,84.03,1.58,5,19,24
2011-11-06 14:00:00,2,1,6.67,34.71,23.14,22,92,114
2011-11-06 15:00:00,4,4,34.97,48.18,36.2,32,47,79
2011-11-06 16:00:00,3,1,25.85,30.07,15.06,13,120,133
2011-11-06 17:00:00,2,2,9.81,63.28,23.14,41,94,135
2011-11-06 18:00:00,4,1,12.12,43.41,10.97,35,60,95
2011-11-06 19:00:00,4,2,25.77,75.11,38.64,17,150,167
2011-11-06 20:00:00,3,2,28.39,20.03,3.03,39,60,99
2011-11-06 21:00:00,4,2,12.17,24.77,35.27,43,79,122
2011-11-06 22:00:00,1,3,12.71,54.6,18.95,9,190,199
2011-11-06 23:00:00,2,2,14.21,96.65,2.08,44,18,62
2011-11-07 00:00:00,2,4,22.94,91.27,42.67,38,12,50
2011-11-07 01:00:00,4,1,10.15,99.52,24.39,48,129,177
2011-11-07 02:00:00,4,4,8.13,53.35,29.97,11,178,189
2011-11-07 03:00:00,1,3,25.37,23.73,36.6,37,74,111
2011-11-07 04:00:00,3,1,28.37,44.48,32.75,22,0,22
2011-11-07 05:00:00,4,2,20.03,74.06,36.54,6,168,174
2011-11-07 06:00:00,4,1,15.91,30.81,38.11,44,137,181
2011-11-07 07:00:00,4,3,17.96,44.0,29.46,45,2,47
2011-11-07 08:00:00,4,3,16.65,24.49,18.28,24,7,31
2011-11-07 09:00:00,2,4,33.8,58.0,12.16,12,79,91
2011-11-07 10:00:00,4,1,28.04,36.71,45.15,37,163,200
2011-11-07 11:00:00,2,1,11.24,27.3,48.5,18,106,124
2011-11-07 12:00:00,4,1,16.53,52.9,17.88,44,39,83
2011-11-07 13:00:00,3,4,21.32,48.1,5.62,21,166,187
2011-11-07 14:00:00,1,3,23.39,63.0,11.13,40,174,214
2011-11-07 15:00:00,3,2,19.05,79.92,33.53,10,118,128
2011-11-07 16:00:00,4,1,29.3,29.01,8.65,41,187,228
2011-11-07 17:00:00,4,4,28.03,83.29,39.01,2,7,9
2011-11-07 18:00:00,4,4,20.15,22.1,46.15,18,73,91
2011-11-07 19:00:00,3,2,30.63,55.45,48.18,26,164,190
2011-11-07 20:00:00,4,3,27.53,66.99,0.47,6,190,196
2011-11-07 21:00:00,3,1,28.36,96.56,47.91,36,26,62
2011-11-07 22:00:00,2,1,33.69,65.91,37.01,26,94,120
2011-11-07 23:00:00,1,4,12.99,32.7,4.2,46,130,176
2011-11-08 00:00:00,1,3,13.03,61.4,20.76,33,166,199
2011-11-08 01:00:00,3,1,31.67,51.66,35.0,10,5,15
2011-11-08 02:00:00,2,2,28.17,58.35,47.83,37,9,46
2011-11-08 03:00:00,3,3,32.8,35.77,8.21,4,156,160
2011-11-08 04:00:00,2,3,6.89,60.07,6.39,6,28,34
2011-11-08 05:00:00,4,4,23.83,32.0,23.62,35,147,182
2011-11-08 06:00:00,2,4,9.34,79.52,48.4,4,78,82
2011-11-08 07:00:00,2,1,20.12,67.51,48.57,4,65,69
2011-11-08 08:00:00,2,4,9.67,26.28,11.4,26,11,37
2011-11-08 09:00:00,1,3,8.84,91.17,15.97,28,12,40
2011-11-08 10:00:00,2,1,5.37,69.31,45.4,26,107,133
2011-11-08 11:00:00,4,1,23.91,45.29,36.74,31,166,197
2011-11-08 12:00:00,4,3,15.77,23.65,48.62,24,166,190
2011-11-08 13:00:00,4,1,8.16,70.58,44.66,41,101,142
2011-11-08 14:00:00,2,2,14.69,49.88,10.75,49,172,221
2011-11-08 15:00:00,3,2,10.07,92.61,37.99,33,168,201
2011-11-08 16:00:00,3,1,33.25,22.79,2.43,14,90,104
2011-11-08 17:00:00,4,4,14.6,23.13,40.89,40,170,210
2011-11-08 18:00:00,1,2,15.02,95.94,30.08,33,61,94
2011-11-08 19:00:00,3,1,30.2,97.19,47.81,34,130,164
2011-11-08 20:00:00,2,2,24.43,22.22,48.0,19,8,27
2011-11-08 21:00:00,3,4,26.31,77.28,2.54,23,171,194
2011-11-08 22:00:00,4,3,24.08,37.72,8.03,33,124,157
2011-11-08 23:00:00,1,1,33.39,76.11,24.21,33,161,194
2011-11-09 00:00:00,3,1,11.21,89.5,43.97,45,18,63
2011-11-09 01:00:00,3,1,34.67,28.07,40.72,26,89,115
2011-11-09 02:00:00,4,1,29.93,39.1,48.22,49,86,135
2011-11-09 03:00:00,1,1,22.67,21.93,30.9,20,17,37
2011-11-09 04:00:00,1,1,24.87,23.51,12.83,32,173,205
2011-11-09 05:00:00,4,4,24.46,22.37,1.26,38,103,141
2011-11-09 06:00:00,2,3,6.75,84.05,11.15,39,168,207
2011-11-09 07:00:00,3,4,11.54,43.86,33.76,43,125,168
2011-11-09 08:00:00,2,4,33.84,59.46,46.31,35,48,83
2011-11-09 09:00:00,3,3,21.03,83.03,16.05,24,101,125
2011-11-09 10:00:00,3,4,16.35,59.6,43.79,6,179,185
2011-11-09 11:00:00,2,2,27.86,54.34,19.74,49,73,122
2011-11-09 12:00:00,4,4,20.74,20.93,15.41,49,170,219
2011-11-09 13:00:00,4,1,5.39,65.44,25.44,9,137,146
2011-11-09 14:00:00,3,2,27.09,29.98,22.11,9,84,93
2011-11-09 15:00:00,4,2,26.97,81.17,45.69,37,165,202
2011-11-09 16:00:00,3,3,9.95,40.62,23.41,23,37,60
2011-11-09 17:00:00,4,4,33.7,73.93,13.87,43,174,217
2011-11-09 18:00:00,3,4,11.72,71.7,42.13,9,134,143
2011-11-09 19:00:00,4,2,18.73,69.33,49.94,44,11,55
2011-11-09 20:00:00,1,4,8.44,41.36,32.41,25,51,76
2011-11-09 21:00:00,2,4,23.1,41.37,12.52,29,104,133
2011-11-09 22:00:00,1,3,16.26,89.04,11.94,26,160,186
2011-11-09 23:00:00,2,2,15.6,21.02,2.89,43,91,134
2011-11-10 00:00:00,2,1,29.81,34.52,3.86,18,23,41
2011-11-10 01:00:00,3,2,5.29,68.81,45.75,0,175,175
2011-11-10 02:00:00,2,3,28.94,85.36,4.82,32,30,62
2011-11-10 03:00:00,1,3,22.14,48.67,24.22,10,81,91
2011-11-10 04:00:00,1,3,34.58,72.28,34.91,49,22,71
2011-11-10 05:00:00,4,4,22.68,64.57,42.52,33,70,103
2011-11-10 06:00:00,1,2,6.66,25.16,8.56,37,71,108
2011-11-10 07:00:00,4,4,6.52,69.74,21.89,15,117,132
2011-11-10 08:00:00,2,4,31.49,85.11,12.57,0,142,142
2011-11-10 09:00:00,1,2,30.24,99.4,12.79,40,37,77
2011-11-10 10:00:00,2,3,15.38,22.37,15.19,27,155,182
2011-11-10 11:00:00,1,1,23.54,72.8,29.36,14,90,104
2011-11-10 12:00:00,1,1,19.69,53.16,0.83,15,126,141
2011-11-10 13:00:00,4,2,34.01,20.78,20.44,45,20,65
2011-11-10 14:00:00,2,2,33.5,69.15,9.34,31,26,57
2011-11-10 15:00:00,1,3,34.52,29.79,48.36,38,174,212
2011-11-10 16:00:00,3,2,30.99,50.29,29.14,0,55,55
2011-11-10 17:00:00,2,2,32.29,40.91,43.4,47,124,171
2011-11-10 18:00:00,2,3,11.52,48.89,9.78,8,105,113
2011-11-10 19:00:00,2,3,29.93,59.42,40.5,28,141,169
2011-11-10 20:00:00,4,4,26.27,48.74,20.74,24,20,44
2011-11-10 21:00:00,3,2,33.88,64.22,8.88,10,13,23
2011-11-10 22:00:00,2,1,22.14,39.09,38.06,41,106,147
2011-11-10 23:00:00,1,2,7.56,70.83,38.1,10,69,79
2011-11-11 00:00:00,1,1,22.92,88.3,49.79,5,27,32
2011-11-11 01:00:00,4,1,25.6,37.93,39.05,33,112,145
2011-11-11 02:00:00,1,1,11.61,60.63,7.26,49,164,213
2011-11-11 03:00:00,2,4,16.82,71.9,16.13,43,101,144
2011-11-11 04:00:00,1,3,22.96,65.17,22.59,13,66,79
2011-11-11 05:00:00,2,3,16.22,49.25,6.33,7,123,130
2011-11-11 06:00:00,1,4,16.25,71.38,39.4,24,32,56
2011-11-11 07:00:00,3,3,8.99,22.26,26.33,3,11,14
2011-11-11 08:00:00,4,4,33.22,49.59,47.22,49,139,188
2011-11-11 09:00:00,4,2,27.51,62.61,29.47,30,178,208
2011-11-11 10:00:00,3,4,5.04,21.65,26.14,20,162,182
2011-11-11 11:00:00,3,3,27.97,60.61,3.57,44,102,146
2011-11-11 12:00:00,4,3,27.19,72.34,7.47,31,11,42
2011-11-11 13:00:00,3,2,5.29,80.74,42.48,13,18,31
2011-11-11 14:00:00,2,4,16.09,29.07,49.53,27,94,121
2011-11-11 15:00:00,1,2,23.2,99.25,20.76,24,58,82
2011-11-11 16:00:00,4,1,18.58,68.49,40.5,27,116,143
2011-11-11 17:00:00,3,4,28.34,49.06,31.38,14,12,26
2011-11-11 18:00:00,2,2,17.76,39.93,47.95,45,18,63
2011-11-11 19:00:00,4,2,9.62,65.83,11.91,43,163,206
2011-11-11 20:00:00,3,3,34.29,90.54,27.24,21,131,152
2011-11-11 21:00:00,4,4,12.26,61.65,20.44,46,12,58
2011-11-11 22:00:00,3,1,26.53,72.92,27.09,5,83,88
2011-11-11 23:00:00,4,1,9.29,48.62,13.44,1,133,134
2011-11-12 00:00:00,2,4,14.87,51.05,24.89,5,43,48
2011-11-12 01:00:00,2,4,18.26,42.89,31.24,22,75,97
2011-11-12 02:00:00,1,2,10.77,76.45,4.06,25,108,133
2011-11-12 03:00:00,4,3,18.5,48.74,37.15,10,80,90
2011-11-12 04:00:00,1,3,9.71,35.26,35.33,0,135,135
2011-11-12 05:00:00,4,3,21.77,49.55,44.02,27,160,187
2011-11-12 06:00:00,3,4,24.91,88.31,21.29,21,120,141
2011-11-12 07:00:00,3,3,6.87,79.06,3.08,40,51,91
2011-11-12 08:00:00,1,2,31.13,46.77,23.07,12,102,114
2011-11-12 09:00:00,4,4,10.55,92.54,6.88,40,116,156
2011-11-12 10:00:00,1,4,11.76,25.99,32.37,46,89,135
2011-11-12 11:00:00,2,3,24.84,23.98,2.36,49,82,131
2011-11-12 12:00:00,1,1,19.06,30.2,18.7,35,12,47
2011-11-12 13:00:00,1,1,19.98,29.32,4.14,21,119,140
2011-11-12 14:00:00,3,2,8.84,27.03,0.17,3,137,140
2011-11-12 15:00:00,1,3,29.17,72.91,48.03,43,161,204
2011-11-12 16:00:00,4,3,23.51,68.07,49.81,40,94,134
2011-11-12 17:00:00,3,4,9.06,71.81,27.78,17,154,171
2011-11-12 18:00:00,1,4,16.22,75.07,11.95,37,185,222
2011-11-12 19:00:00,2,3,29.31,80.55,45.55,16,194,210
2011-11-12 20:00:00,1,4,22.05,36.57,46.15,24,171,195
2011-11-12 21:00:00,1,3,8.26,69.78,42.73,16,68,84
2011-11-12 22:00:00,1,2,16.18,66.4,27.22,28,4,32
2011-11-12 23:00:00,3,4,12.28,95.49,3.74,44,164,208
2011-11-13 00:00:00,4,3,20.52,38.59,4.42,43,70,113
2011-11-13 01:00:00,2,4,30.3,24.7,44.83,45,103,148
2011-11-13 02:00:00,1,2,18.09,72.28,43.79,7,55,62
2011-11-13 03:00:00,4,4,18.0,79.21,21.72,28,50,78
2011-11-13 04:00:00,4,3,32.16,42.66,16.41,14,55,69
2011-11-13 05:00:00,3,4,22.29,65.67,32.21,40,169,209
2011-11-13 06:00:00,2,4,21.99,24.76,40.35,32,140,172
2011-11-13 07:00:00,3,3,12.86,96.8,36.58,48,33,81
2011-11-13 08:00:00,4,1,23.23,28.79,30.78,9,99,108
2011-11-13 09:00:00,4,4,22.28,25.41,11.58,36,161,197
2011-11-13 10:00:00,4,4,16.91,23.53,13.13,10,52,62
2011-11-13 11:00:00,3,2,34.72,54.18,36.2,34,2,36
2011-11-13 12:00:00,2,1,31.46,27.77,40.13,33,73,106
2011-11-13 13:00:00,1,2,27.49,79.57,5.81,31,106,137
2011-11-13 14:00:00,3,3,21.12,91.91,9.36,21,98,119
2011-11-13 15:00:00,4,3,18.86,40.82,34.02,3,36,39
2011-11-13 16:00:00,3,2,10.55,70.3,19.45,1,179,180
2011-11-13 17:00:00,4,4,14.17,23.39,28.16,32,133,165
2011-11-13 18:00:00,1,1,28.22,50.93,30.74,8,148,156
2011-11-13 19:00:00,1,2,18.61,43.44,38.81,34,44,78
2011-11-13 20:00:00,2,2,31.47,38.29,40.29,37,132,169
2011-11-13 21:00:00,4,3,9.44,71.58,14.0,30,2,32
2011-11-13 22:00:00,2,4,20.25,30.42,27.06,13,19,32
2011-11-13 23:00:00,2,1,24.41,88.86,6.18,30,60,90
2011-11-14 00:00:00,1,2,20.51,73.19,42.1,32,162,194
2011-11-14 01:00:00,3,1,31.68,76.86,42.27,43,159,202
2011-11-14 02:00:00,3,1,34.69,94.83,14.98,15,146,161
2011-11-14 03:00:00,2,2,8.48,95.39,8.03,19,142,161
2011-11-14 04:00:00,1,1,8.9,64.13,3.5,49,73,122
2011-11-14 05:00:00,4,3,8.91,59.63,28.75,13,56,69
2011-11-14 06:00:00,3,4,25.44,46.83,4.57,34,153,187
2011-11-14 07:00:00,2,4,16.18,77.25,34.03,45,69,114
2011-11-14 08:00:00,3,4,27.0,63.06,33.91,48,110,158
2011-11-14 09:00:00,3,3,17.16,94.63,30.7,44,89,133
2011-11-14 10:00:00,4,3,23.83,39.09,43.83,32,129,161
2011-11-14 11:00:00,1,3,28.1,44.82,18.91,28,48,76
2011-11-14 12:00:00,4,4,21.45,45.29,45.11,7,175,182
2011-11-14 13:00:00,1,1,21.19,84.48,1.85,33,159,192
2011-11-14 14:00:00,3,3,7.65,27.92,5.64,46,130,176
2011-11-14 15:00:00,2,2,17.32,56.45,20.61,13,147,160
2011-11-14 16:00:00,4,3,21.37,54.21,29.7,13,93,106
2011-11-14 17:00:00,1,2,18.86,25.85,1.62,49,164,213
2011-11-14 18:00:00,3,4,32.02,52.86,28.37,14,108,122
2011-11-14 19:00:00,1,2,32.2,61.07,15.37,41,147,188
2011-11-14 20:00:00,1,3,29.66,25.21,44.36,49,59,108
2011-11-14 21:00:00,1,3,16.26,60.79,26.66,19,97,116
2011-11-14 22:00:00,3,1,26.52,96.74,29.39,27,186,213
2011-11-14 23:00:00,2,4,16.86,98.31,47.28,3,80,83
2011-11-15 00:00:00,2,2,11.98,62.53,38.21,6,41,47
2011-11-15 01:00:00,2,4,15.29,61.21,21.91,1,150,151
2011-11-15 02:00:00,1,3,7.13,42.84,23.84,8,168,176
2011-11-15 03:00:00,3,1,14.95,99.77,32.4,22,72,94
2011-11-15 04:00:00,1,3,18.82,41.94,10.01,35,26,61
2011-11-15 05:00:00,2,3,33.66,56.23,4.43,11,80,91
2011-11-15 06:00:00,2,3,14.4,20.23,15.56,22,173,195
2011-11-15 07:00:00,3,2,32.07,47.94,38.92,30,16,46
2011-11-15 08:00:00,1,3,11.87,25.72,12.87,41,112,153
2011-11-15 09:00:00,4,4,10.73,79.51,6.54,10,129,139
2011-11-15 10:00:00,4,4,20.57,64.88,10.95,0,14,14
2011-11-15 11:00:00,2,1,25.18,65.77,33.95,12,117,129
2011-11-15 12:00:00,3,4,6.33,42.92,30.7,38,184,222
2011-11-15 13:00:00,1,3,11.63,85.19,34.42,28,168,196
2011-11-15 14:00:00,1,3,18.67,20.26,16.1,5,72,77
2011-11-15 15:00:00,2,4,14.93,46.69,45.04,30,13,43
2011-11-15 16:00:00,2,1,26.38,72.76,22.59,8,7,15
2011-11-15 17:00:00,1,1,20.33,92.63,25.69,17,75,92
2011-11-15 18:00:00,1,4,9.81,38.77,47.44,2,134,136
2011-11-15 19:00:00,2,2,31.83,63.29,48.96,31,66,97
2011-11-15 20:00:00,1,2,13.79,63.04,33.08,44,153,197
2011-11-15 21:00:00,4,2,26.93,89.93,47.24,2,2,4
2011-11-15 22:00:00,2,2,28.4,24.04,27.08,44,173,217
2011-11-15 23:00:00,1,4,33.89,53.96,15.36,29,131,160
2011-11-16 00:00:00,2,1,19.96,34.6,15.75,5,184,189
2011-11-16 01:00:00,3,3,23.48,21.72,27.95,49,123,172
2011-11-16 02:00:00,2,3,15.05,31.76,30.25,26,173,199
2011-11-16 03:00:00,2,4,25.35,98.12,21.98,1,13,14
2011-11-16 04:00:00,3,3,18.9,37.19,44.19,19,130,149
2011-11-16 05:00:00,4,2,18.13,94.8,21.33,16,140,156
2011-11-16 06:00:00,1,1,30.66,36.42,13.67,32,135,167
2011-11-16 07:00:00,3,4,6.51,94.5,0.4,16,183,199
2011-11-16 08:00:00,2,1,31.46,72.37,48.53,36,129,165
2011-11-16 09:00:00,1,4,30.56,29.06,41.22,28,101,129
2011-11-16 10:00:00,3,4,20.19,66.55,30.78,8,115,123
2011-11-16 11:00:00,1,4,19.71,45.48,41.53,3,45,48
2011-11-16 12:00:00,1,4,15.85,50.65,40.51,45,30,75
2011-11-16 13:00:00,3,1,34.83,55.21,46.59,39,90,129
2011-11-16 14:00:00,1,3,8.34,53.82,19.3,12,34,46
2011-11-16 15:00:00,4,4,22.71,73.13,27.74,5,61,66
2011-11-16 16:00:00,3,2,25.45,81.47,4.93,45,173,218
2011-11-16 17:00:00,4,4,33.03,46.33,48.27,8,151,159
2011-11-16 18:00:00,2,1,28.41,93.95,49.26,25,64,89
2011-11-16 19:00:00,1,4,24.32,95.08,39.45,48,89,137
2011-11-16 20:00:00,2,2,8.5,23.26,22.71,38,43,81
2011-11-16 21:00:00,2,1,16.21,21.19,24.83,40,98,138
2011-11-16 22:00:00,1,4,9.17,54.01,21.77,46,50,96
2011-11-16 23:00:00,3,2,31.44,67.25,14.67,41,107,148
2011-11-17 00:00:00,1,1,27.49,42.23,26.39,13,87,100
2011-11-17 01:00:00,2,4,27.73,40.75,2.67,47,173,220
2011-11-17 02:00:00,2,2,24.57,74.27,49.59,33,32,65
2011-11-17 03:00:00,3,1,20.21,68.14,21.2,3,191,194
2011-11-17 04:00:00,1,4,9.5,33.37,46.37,20,153,173
2011-11-17 05:00:00,2,1,14.89,90.76,36.21,30,100,130
2011-11-17 06:00:00,4,2,9.11,74.4,14.5,46,166,212
2011-11-17 07:00:00,2,4,26.75,49.01,11.1,42,57,99
2011-11-17 08:00:00,2,4,9.81,74.69,49.78,20,114,134
2011-11-17 09:00:00,3,4,26.06,29.01,38.61,42,25,67
2011-11-17 10:00:00,4,2,25.77,57.46,12.48,28,116,144
2011-11-17 11:00:00,2,3,18.78,33.52,3.37,23,74,97
2011-11-17 12:00:00,2,4,9.06,23.31,34.85,44,92,136
2011-11-17 13:00:00,4,2,14.44,47.07,15.15,15,194,209
2011-11-17 14:00:00,1,1,14.6,32.06,11.07,8,56,64
2011-11-17 15:00:00,1,1,26.01,70.68,36.75,20,69,89
2011-11-17 16:00:00,2,2,8.41,73.93,33.96,1,72,73
2011-11-17 17:00:00,2,3,29.87,31.9,24.07,1,7,8
2011-11-17 18:00:00,1,2,27.83,21.97,47.13,36,90,126
2011-11-17 19:00:00,3,1,10.59,83.42,33.98,36,125,161
2011-11-17 20:00:00,4,1,26.57,20.16,44.67,4,33,37
2011-11-17 21:00:00,4,4,25.06,47.51,9.53,45,68,113
2011-11-17 22:00:00,3,3,27.44,59.57,14.83,5,9,14
2011-11-17 23:00:00,3,2,10.67,85.49,5.23,47,21,68
2011-11-18 00:00:00,3,1,9.73,87.08,15.23,47,139,186
2011-11-18 01:00:00,3,1,12.09,78.0,48.59,7,156,163
2011-11-18 02:00:00,3,1,15.98,39.78,48.14,31,158,189
2011-11-18 03:00:00,3,2,28.81,77.61,38.02,36,5,41
2011-11-18 04:00:00,4,2,27.14,39.72,26.05,12,109,121
2011-11-18 05:00:00,3,3,32.76,37.17,39.04,2,6,8
2011-11-18 06:00:00,1,4,6.76,63.77,27.67,8,96,104
2011-11-18 07:00:00,3,4,5.35,74.31,0.18,3,109,112
2011-11-18 08:00:00,3,4,25.97,24.24,25.08,27,12,39
2011-11-18 09:00:00,4,1,13.38,24.8,29.95,39,62,101
2011-11-18 10:00:00,4,4,15.02,82.73,13.29,15,23,38
2011-11-18 11:00:00,3,1,21.4,88.76,10.16,10,93,103
2011-11-18 12:00:00,4,3,8.07,68.36,13.69,18,96,114
2011-11-18 13:00:00,2,1,24.28,54.31,31.18,41,83,124
2011-11-18 14:00:00,4,3,14.75,87.63,7.3,21,18,39
2011-11-18 15:00:00,4,3,23.98,78.31,36.02,38,82,120
2011-11-18 16:00:00,4,4,30.02,66.37,21.13,11,87,98
2011-11-18 17:00:00,4,4,10.13,45.58,17.67,29,68,97
2011-11-18 18:00:00,1,1,32.93,35.84,40.36,39,149,188
2011-11-18 19:00:00,1,2,20.92,53.49,25.3,41,59,100
2011-11-18 20:00:00,1,4,32.69,42.95,18.92,4,21,25
2011-11-18 21:00:00,3,4,11.23,47.14,43.91,36,91,127
2011-11-18 22:00:00,3,2,23.14,61.25,18.41,44,144,188
2011-11-18 23:00:00,2,2,17.12,33.53,42.95,31,94,125
2011-11-19 00:00:00,1,4,28.23,84.49,25.21,33,174,207
2011-11-19 01:00:00,3,2,23.18,31.64,10.4,11,134,145
2011-11-19 02:00:00,4,1,19.84,58.48,30.64,42,144,186
2011-11-19 03:00:00,4,3,32.39,79.68,14.27,1,189,190
2011-11-19 04:00:00,1,3,16.31,58.8,7.36,46,190,236
2011-11-19 05:00:00,2,4,11.6,48.88,4.33,6,134,140
2011-11-19 06:00:00,2,4,23.24,57.99,12.08,31,28,59
2011-11-19 07:00:00,4,1,23.72,87.89,36.83,39,199,238
2011-11-19 08:00:00,2,2,18.17,99.23,41.9,34,3,37
2011-11-19 09:00:00,1,4,19.6,70.49,43.09,48,103,151
2011-11-19 10:00:00,4,3,33.79,83.48,13.51,5,117,122
2011-11-19 11:00:00,3,1,26.98,21.16,33.05,21,15,36
2011-11-19 12:00:00,3,1,8.32,90.43,11.52,24,79,103
2011-11-19 13:00:00,2,2,11.36,96.32,31.14,46,85,131
2011-11-19 14:00:00,4,4,34.27,66.01,44.36,12,74,86
2011-11-19 15:00:00,4,4,26.79,80.3,2.04,22,186,208
2011-11-19 16:00:00,3,1,32.45,61.02,49.26,44,40,84
2011-11-19 17:00:00,4,3,14.12,42.9,41.35,43,59,102
2011-11-19 18:00:00,4,4,27.26,88.18,38.08,45,196,241
2011-11-19 19:00:00,4,3,26.42,67.75,34.57,8,57,65
2011-11-19 20:00:00,2,1,13.84,66.35,38.51,41,111,152
2011-11-19 21:00:00,4,4,21.52,72.73,49.73,36,39,75
2011-11-19 22:00:00,1,3,23.82,88.48,38.51,36,57,93
2011-11-19 23:00:00,2,1,19.43,78.55,17.58,29,188,217
2011-11-20 00:00:00,4,3,29.82,36.89,30.7,19,172,191
2011-11-20 01:00:00,4,4,29.99,57.35,16.85,37,76,113
2011-11-20 02:00:00,1,2,30.52,98.42,48.5,43,47,90
2011-11-20 03:00:00,2,3,29.1,64.36,45.01,48,89,137
2011-11-20 04:00:00,3,2,19.64,95.06,28.38,15,10,25
2011-11-20 05:00:00,3,4,16.44,85.07,39.06,49,55,104
2011-11-20 06:00:00,2,2,29.94,73.28,45.48,21,22,43
2011-11-20 07:00:00,4,1,19.71,47.95,12.18,37,32,69
2011-11-20 08:00:00,4,2,12.39,44.35,28.97,9,179,188
2011-11-20 09:00:00,3,3,20.22,71.47,24.09,19,115,134
2011-11-20 10:00:00,3,3,9.26,54.6,38.58,40,27,67
2011-11-20 11:00:00,3,2,25.75,83.9,18.95,1,114,115
2011-11-20 12:00:00,1,1,15.08,80.84,35.45,2,131,133
2011-11-20 13:00:00,3,4,12.82,44.97,20.15,41,178,219
2011-11-20 14:00:00,1,2,33.7,76.22,5.55,7,137,144
2011-11-20 15:00:00,2,3,28.31,59.56,5.36,8,51,59
2011-11-20 16:00:00,4,3,28.61,45.86,5.95,27,199,226
2011-11-20 17:00:00,3,2,23.71,53.04,1.63,20,8,28
2011-11-20 18:00:00,4,2,30.18,91.63,26.65,32,17,49
2011-11-20 19:00:00,4,2,27.77,48.76,33.6,33,193,226
2011-11-20 20:00:00,3,4,22.96,42.99,6.34,3,81,84
2011-11-20 21:00:00,3,3,33.83,48.14,30.59,47,167,214
2011-11-20 22:00:00,2,3,10.75,37.17,29.89,24,65,89
2011-11-20 23:00:00,1,3,33.3,63.57,7.35,31,21,52
2011-11-21 00:00:00,1,4,17.04,31.79,20.2,11,79,90
2011-11-21 01:00:00,4,1,20.85,85.4,37.76,1,100,101
2011-11-21 02:00:00,3,3,8.68,38.05,0.84,46,95,141
2011-11-21 03:00:00,2,3,21.2,67.84,7.35,49,73,122
2011-11-21 04:00:00,2,1,23.34,30.0,49.79,47,104,151
2011-11-21 05:00:00,2,4,34.93,98.28,36.68,11,161,172
2011-11-21 06:00:00,2,1,34.26,56.37,23.21,49,175,224
2011-11-21 07:00:00,2,1,33.99,85.77,31.49,45,15,60
2011-11-21 08:00:00,1,1,15.45,81.49,42.31,25,48,73
2011-11-21 09:00:00,1,1,34.74,77.1,42.12,20,97,117
2011-11-21 10:00:00,1,4,18.66,86.19,16.24,43,100,143
2011-11-21 11:00:00,3,4,30.56,28.04,24.56,36,62,98
2011-11-21 12:00:00,4,1,11.49,74.28,31.9,35,167,202
2011-11-21 13:00:00,2,2,20.17,41.27,3.59,17,55,72
2011-11-21 14:00:00,3,2,33.98,82.87,47.29,23,97,120
2011-11-21 15:00:00,2,2,33.41,96.55,21.64,29,107,136
2011-11-21 16:00:00,1,2,25.51,92.12,18.54,16,76,92
2011-11-21 17:00:00,3,3,28.93,29.2,45.36,15,175,190
2011-11-21 18:00:00,1,4,10.29,49.56,5.91,41,36,77
2011-11-21 19:00:00,2,4,26.65,49.15,1.96,16,139,155
2011-11-21 20:00:00,2,1,23.54,29.78,34.25,43,92,135
2011-11-21 21:00:00,4,3,7.75,27.85,19.25,11,97,108
2011-11-21 22:00:00,2,1,8.39,50.79,38.22,26,31,57
2011-11-21 23:00:00,1,1,8.25,99.37,3.43,3,107,110
2011-11-22 00:00:00,2,4,26.73,65.52,19.19,34,150,184
2011-11-22 01:00:00,4,3,9.25,69.74,11.77,0,73,73
2011-11-22 02:00:00,4,2,19.03,57.68,36.98,11,71,82
2011-11-22 03:00:00,1,4,15.71,72.99,11.36,28,20,48
2011-11-22 04:00:00,3,3,21.52,96.53,22.9,7,139,146
2011-11-22 05:00:00,2,3,26.19,67.1,40.94,7,176,183
2011-11-22 06:00:00,4,4,25.54,25.2,45.77,11,102,113
2011-11-22 07:00:00,2,4,20.47,59.43,36.13,35,174,209
2011-11-22 08:00:00,2,1,18.93,99.42,21.46,47,97,144
2011-11-22 09:00:00,3,1,16.93,50.99,28.6,33,61,94
2011-11-22 10:00:00,4,1,30.86,67.51,34.48,35,37,72
2011-11-22 11:00:00,2,2,14.93,28.53,43.75,3,97,100
2011-11-22 12:00:00,4,4,12.78,31.29,44.43,10,109,119
2011-11-22 13:00:00,1,3,27.3,89.97,46.55,2,153,155
2011-11-22 14:00:00,1,4,15.79,44.03,40.54,9,39,48
2011-11-22 15:00:00,2,3,30.41,44.44,7.34,11,143,154
2011-11-22 16:00:00,4,2,14.84,50.98,37.38,48,18,66
2011-11-22 17:00:00,2,4,26.06,97.32,40.73,8,177,185
2011-11-22 18:00:00,4,3,6.35,26.75,43.89,20,183,203
2011-11-22 19:00:00,4,3,16.57,85.5,46.24,33,28,61
2011-11-22 20:00:00,3,1,15.3,47.32,25.46,21,108,129
2011-11-22 21:00:00,3,2,29.5,87.96,32.75,17,165,182
2011-11-22 22:00:00,3,4,34.01,99.34,0.48,43,188,231
2011-11-22 23:00:00,2,1,18.83,47.89,28.64,5,163,168
2011-11-23 00:00:00,3,2,29.75,30.35,23.66,24,84,108
2011-11-23 01:00:00,3,1,25.99,31.55,48.12,49,9,58
2011-11-23 02:00:00,1,4,34.02,80.7,45.09,44,174,218
2011-11-23 03:00:00,4,3,29.33,31.59,39.88,14,171,185
2011-11-23 04:00:00,4,4,7.32,40.83,2.85,0,115,115
2011-11-23 05:00:00,3,2,26.4,36.35,20.1,39,107,146
2011-11-23 06:00:00,4,4,21.06,48.45,34.8,17,189,206
2011-11-23 07:00:00,1,2,5.49,25.95,1.48,43,6,49
2011-11-23 08:00:00,1,1,12.54,88.54,11.79,30,196,226
2011-11-23 09:00:00,3,2,32.65,88.81,44.38,19,18,37
2011-11-23 10:00:00,1,3,32.78,53.03,6.49,43,109,152
2011-11-23 11:00:00,4,3,28.97,68.97,2.57,24,32,56
2011-11-23 12:00:00,2,3,34.45,71.36,29.03,32,151,183
2011-11-23 13:00:00,4,1,29.2,79.94,47.32,9,22,31
2011-11-23 14:00:00,2,2,5.31,61.66,41.73,28,85,113
2011-11-23 15:00:00,3,1,13.64,60.83,48.74,18,99,117
2011-11-23 16:00:00,2,4,5.92,70.5,37.68,27,180,207
2011-11-23 17:00:00,1,4,7.82,76.24,21.87,26,109,135
2011-11-23 18:00:00,4,4,11.57,47.74,47.33,18,148,166
2011-11-23 19:00:00,2,4,20.11,46.43,21.33,42,81,123
2011-11-23 20:00:00,4,3,30.43,41.58,17.5,30,101,131
2011-11-23 21:00:00,3,2,30.86,63.91,22.41,34,90,124
2011-11-23 22:00:00,3,3,23.49,48.81,40.7,13,36,49
2011-11-23 23:00:00,1,2,32.85,63.23,45.88,49,48,97
2011-11-24 00:00:00,3,2,20.0,52.48,17.88,5,152,157
2011-11-24 01:00:00,2,1,31.67,86.94,23.11,8,38,46
2011-11-24 02:00:00,3,4,18.62,25.85,44.92,40,29,69
2011-11-24 03:00:00,1,2,13.32,65.78,2.35,26,42,68
2011-11-24 04:00:00,4,4,32.49,66.05,39.19,16,181,197
2011-11-24 05:00:00,4,4,16.64,50.7,22.71,35,31,66
2011-11-24 06:00:00,3,4,20.1,53.68,18.83,3,125,128
2011-11-24 07:00:00,2,3,14.87,84.01,22.35,23,94,117
2011-11-24 08:00:00,1,4,24.89,42.45,20.93,15,176,191
2011-11-24 09:00:00,2,2,34.85,89.71,37.83,16,1,17
2011-11-24 10:00:00,1,3,5.77,91.71,46.4,2,46,48
2011-11-24 11:00:00,3,4,32.0,72.05,24.57,38,98,136
2011-11-24 12:00:00,1,1,5.12,81.83,41.64,36,22,58
2011-11-24 13:00:00,1,4,15.93,69.04,36.6,2,133,135
2011-11-24 14:00:00,3,4,10.06,62.02,16.53,43,84,127
2011-11-24 15:00:00,2,3,27.72,97.33,29.37,40,40,80
2011-11-24 16:00:00,3,2,6.52,42.61,33.34,34,41,75
2011-11-24 17:00:00,1,4,21.6,32.33,1.17,2,180,182
2011-11-24 18:00:00,3,3,13.85,43.0,19.8,15,71,86
2011-11-24 19:00:00,1,3,9.01,69.17,49.63,19,166,185
2011-11-24 20:00:00,3,2,28.15,34.81,31.86,44,137,181
2011-11-24 21:00:00,4,3,11.52,92.71,16.71,5,111,116
2011-11-24 22:00:00,4,2,11.71,52.88,12.5,32,49,81
2011-11-24 23:00:00,3,1,13.25,88.0,10.47,42,74,116
2011-11-25 00:00:00,2,4,22.6,39.94,20.08,49,135,184
2011-11-25 01:00:00,1,3,24.79,45.05,9.66,26,0,26
2011-11-25 02:00:00,4,1,5.53,24.74,6.76,29,199,228
2011-11-25 03:00:00,2,3,12.26,40.62,18.2,34,196,230
2011-11-25 04:00:00,1,3,17.93,59.23,30.35,17,0,17
2011-11-25 05:00:00,4,1,14.96,95.69,7.32,29,194,223
2011-11-25 06:00:00,4,3,31.53,51.11,2.22,42,26,68
2011-11-25 07:00:00,3,3,28.63,71.18,1.73,25,108,133
2011-11-25 08:00:00,1,1,23.78,54.22,13.37,14,188,202
2011-11-25 09:00:00,2,3,15.14,23.74,9.51,31,124,155
2011-11-25 10:00:00,2,2,26.02,60.28,26.96,34,175,209
2011-11-25 11:00:00,2,3,30.31,25.27,22.79,11,22,33
2011-11-25 12:00:00,1,4,22.84,90.7,16.24,20,171,191
2011-11-25 13:00:00,2,3,28.53,80.24,41.68,11,167,178
2011-11-25 14:00:00,2,4,27.47,50.29,25.25,48,138,186
2011-11-25 15:00:00,2,4,22.15,71.22,4.58,0,108,108
2011-11-25 16:00:00,3,3,14.37,28.96,14.79,10,138,148
2011-11-25 17:00:00,3,1,27.37,76.2,48.67,24,99,123
2011-11-25 18:00:00,1,2,11.2,85.82,48.85,46,101,147
2011-11-25 19:00:00,1,2,28.38,85.74,12.73,8,30,38
2011-11-25 20:00:00,2,3,29.14,42.74,8.36,38,187,225
2011-11-25 21:00:00,3,1,29.66,41.1,24.78,42,54,96
2011-11-25 22:00:00,4,1,19.19,61.71,24.07,26,151,177
2011-11-25 23:00:00,4,2,10.77,97.42,20.51,28,61,89
2011-11-26 00:00:00,2,1,7.99,93.64,26.47,49,146,195
2011-11-26 01:00:00,2,3,27.3,48.77,11.61,26,95,121
2011-11-26 02:00:00,3,3,31.59,82.39,5.75,27,39,66
2011-11-26 03:00:00,3,1,24.53,93.71,28.52,38,101,139
2011-11-26 04:00:00,3,3,9.32,40.87,46.63,17,16,33
2011-11-26 05:00:00,1,4,33.05,86.42,6.89,14,177,191
2011-11-26 06:00:00,1,2,34.67,41.43,35.24,15,98,113
2011-11-26 07:00:00,2,3,18.0,47.46,21.89,46,11,57
2011-11-26 08:00:00,1,1,22.84,35.91,14.7,22,142,164
2011-11-26 09:00:00,3,2,28.32,60.57,42.66,29,166,195
2011-11-26 10:00:00,3,3,27.09,87.46,22.82,35,12,47
2011-11-26 11:00:00,1,2,34.03,62.24,29.17,34,93,127
2011-11-26 12:00:00,4,1,8.45,29.88,22.15,27,105,132
2011-11-26 13:00:00,2,4,22.42,40.14,4.06,45,18,63
2011-11-26 14:00:00,4,4,25.76,65.03,29.75,2,56,58
2011-11-26 15:00:00,2,3,31.7,66.65,20.94,15,91,106
2011-11-26 16:00:00,4,4,31.22,66.15,4.34,14,59,73
2011-11-26 17:00:00,1,3,34.34,26.16,29.79,18,183,201
2011-11-26 18:00:00,2,2,20.36,80.3,0.49,9,152,161
2011-11-26 19:00:00,2,3,29.92,92.75,10.43,48,103,151
2011-11-26 20:00:00,2,3,17.82,60.84,39.05,3,131,134
2011-11-26 21:00:00,3,3,17.67,77.51,1.9,21,179,200
2011-11-26 22:00:00,3,4,12.6,93.12,32.33,17,126,143
2011-11-26 23:00:00,4,3,29.55,71.41,47.49,21,100,121
2011-11-27 00:00:00,1,1,34.57,73.95,8.56,41,134,175
2011-11-27 01:00:00,3,3,12.69,77.71,20.86,15,67,82
2011-11-27 02:00:00,2,2,6.68,40.84,28.77,2,86,88
2011-11-27 03:00:00,3,1,29.47,66.61,22.52,43,107,150
2011-11-27 04:00:00,1,2,23.61,87.37,31.02,34,197,231
2011-11-27 05:00:00,3,2,33.79,43.69,20.2,40,172,212
2011-11-27 06:00:00,2,2,12.57,91.77,7.43,38,136,174
2011-11-27 07:00:00,4,1,7.13,69.63,4.45,15,120,135
2011-11-27 08:00:00,2,1,19.77,53.85,37.22,20,8,28
2011-11-27 09:00:00,1,4,7.56,69.85,11.93,20,130,150
2011-11-27 10:00:00,4,1,12.85,52.15,42.37,0,76,76
2011-11-27 11:00:00,3,3,8.78,87.04,37.15,29,62,91
2011-11-27 12:00:00,3,2,11.72,58.59,2.47,46,118,164
2011-11-27 13:00:00,3,4,8.18,92.1,10.06,33,92,125
2011-11-27 14:00:00,4,1,33.62,60.78,14.6,47,129,176
2011-11-27 15:00:00,2,2,13.36,72.83,29.72,38,158,196
2011-11-27 16:00:00,4,1,18.32,99.82,40.49,45,37,82
2011-11-27 17:00:00,4,4,31.96,31.76,3.02,22,6,28
2011-11-27 18:00:00,1,1,25.32,78.94,12.48,33,103,136
2011-11-27 19:00:00,4,1,23.54,31.11,18.81,29,137,166
2011-11-27 20:00:00,3,2,26.17,87.11,9.17,49,76,125
2011-11-27 21:00:00,2,3,29.86,67.72,27.26,32,186,218
2011-11-27 22:00:00,2,1,31.33,95.05,23.9,15,0,15
2011-11-27 23:00:00,2,4,24.28,89.28,15.82,40,36,76
2011-11-28 00:00:00,3,1,31.7,25.99,25.84,29,152,181
2011-11-28 01:00:00,3,1,21.06,30.98,17.79,2,93,95
2011-11-28 02:00:00,3,3,13.32,68.09,17.16,44,65,109
2011-11-28 03:00:00,3,2,31.4,61.47,13.27,1,99,100
2011-11-28 04:00:00,3,4,21.24,33.49,27.02,25,75,100
2011-11-28 05:00:00,4,2,32.18,30.35,22.21,17,4,21
2011-11-28 06:00:00,3,2,6.21,65.12,9.82,1,55,56
2011-11-28 07:00:00,3,2,16.93,23.91,0.65,39,41,80
2011-11-28 08:00:00,3,1,33.43,89.9,7.55,2,191,193
2011-11-28 09:00:00,3,3,12.49,84.57,2.14,16,48,64
2011-11-28 10:00:00,2,1,33.25,82.83,21.58,23,45,68
2011-11-28 11:00:00,3,4,33.62,21.28,11.25,1,70,71
2011-11-28 12:00:00,4,3,31.46,23.81,21.02,5,1,6
2011-11-28 13:00:00,4,2,21.91,63.99,16.47,39,66,105
2011-11-28 14:00:00,4,3,24.41,99.55,26.9,25,131,156
2011-11-28 15:00:00,1,4,31.09,47.39,36.19,48,61,109
2011-11-28 16:00:00,2,1,28.28,47.55,23.97,5,111,116
2011-11-28 17:00:00,3,1,23.9,30.74,3.1,11,79,90
2011-11-28 18:00:00,1,2,34.47,73.95,0.88,20,26,46
2011-11-28 19:00:00,3,1,25.57,71.73,10.66,15,85,100
2011-11-28 20:00:00,1,1,34.26,28.11,21.25,5,66,71
2011-11-28 21:00:00,1,4,6.72,57.39,2.25,33,112,145
2011-11-28 22:00:00,4,3,9.17,73.37,16.39,2,121,123
2011-11-28 23:00:00,4,1,18.54,59.48,44.35,40,144,184
2011-11-29 00:00:00,1,4,16.55,73.95,4.5,18,179,197
2011-11-29 01:00:00,4,4,28.48,85.3,47.43,28,70,98
2011-11-29 02:00:00,1,2,9.82,74.87,42.83,31,56,87
2011-11-29 03:00:00,2,4,34.28,69.29,41.59,9,29,38
2011-11-29 04:00:00,4,2,14.45,88.29,43.18,26,199,225
2011-11-29 05:00:00,4,1,17.87,92.05,4.0,28,198,226
2011-11-29 06:00:00,4,2,13.24,51.11,7.56,12,192,204
2011-11-29 07:00:00,2,4,22.38,33.86,6.72,19,143,162
2011-11-29 08:00:00,1,3,6.76,85.43,5.56,27,113,140
2011-11-29 09:00:00,3,3,9.49,37.1,16.39,26,121,147
2011-11-29 10:00:00,4,1,27.37,94.32,41.51,12,103,115
2011-11-29 11:00:00,1,1,10.6,21.83,12.6,24,102,126
2011-11-29 12:00:00,2,3,12.07,93.7,12.21,28,154,182
2011-11-29 13:00:00,3,2,28.79,67.13,33.79,14,73,87
2011-11-29 14:00:00,4,1,7.8,81.98,4.85,44,97,141
2011-11-29 15:00:00,2,4,18.12,51.88,18.01,44,174,218
2011-11-29 16:00:00,2,1,5.69,99.34,14.77,29,13,42
2011-11-29 17:00:00,3,2,15.4,38.2,42.37,37,129,166
2011-11-29 18:00:00,1,1,25.97,41.15,25.73,31,166,197
2011-11-29 19:00:00,4,4,7.7,24.11,32.32,49,54,103
2011-11-29 20:00:00,4,4,31.65,95.24,6.45,6,25,31
2011-11-29 21:00:00,1,4,32.28,56.48,46.45,34,43,77
2011-11-29 22:00:00,1,2,8.15,73.99,16.12,32,68,100
2011-11-29 23:00:00,1,2,34.72,75.0,35.34,11,37,48
2011-11-30 00:00:00,3,4,13.93,89.96,47.73,22,79,101
2011-11-30 01:00:00,3,4,7.52,73.19,25.43,4,11,15
2011-11-30 02:00:00,4,2,5.15,64.96,25.38,42,104,146
2011-11-30 03:00:00,3,2,17.26,76.83,5.86,43,107,150
2011-11-30 04:00:00,2,2,23.89,80.08,19.51,30,16,46
2011-11-30 05:00:00,4,3,14.97,34.87,42.62,15,24,39
2011-11-30 06:00:00,3,2,30.1,28.77,6.76,32,191,223
2011-11-30 07:00:00,1,4,26.5,25.99,45.88,49,87,136
2011-11-30 08:00:00,2,3,15.5,49.92,33.37,0,138,138
2011-11-30 09:00:00,1,2,27.03,59.84,21.05,21,145,166
2011-11-30 10:00:00,4,4,33.21,69.25,27.32,27,163,190
2011-11-30 11:00:00,1,1,7.79,96.64,7.52,4,2,6
2011-11-30 12:00:00,3,3,14.18,46.46,10.87,3,82,85
2011-11-30 13:00:00,3,4,18.9,80.87,14.32,0,69,69
2011-11-30 14:00:00,4,1,19.94,62.51,19.24,14,86,100
2011-11-30 15:00:00,1,4,21.27,37.61,45.78,36,70,106
2011-11-30 16:00:00,4,2,14.02,69.22,18.38,38,110,148
2011-11-30 17:00:00,1,2,25.02,97.37,26.19,48,107,155
2011-11-30 18:00:00,2,1,24.35,29.94,8.1,37,8,45
2011-11-30 19:00:00,3,2,22.33,60.58,36.8,44,193,237
2011-11-30 20:00:00,4,4,8.41,24.13,28.01,23,127,150
2011-11-30 21:00:00,2,1,19.31,45.7,22.0,22,121,143
2011-11-30 22:00:00,2,4,15.69,69.65,47.36,46,46,92
2011-11-30 23:00:00,4,4,19.73,87.28,44.53,6,177,183
2011-12-01 00:00:00,4,4,32.66,78.43,32.98,30,63,93
2011-12-01 01:00:00,2,2,19.42,57.03,46.09,6,108,114
2011-12-01 02:00:00,1,2,5.42,92.74,28.24,12,111,123
2011-12-01 03:00:00,2,4,18.17,44.22,41.35,3,46,49
2011-12-01 04:00:00,4,3,29.62,80.32,20.47,17,74,91
2011-12-01 05:00:00,2,4,28.4,57.92,4.34,39,194,233
2011-12-01 06:00:00,1,4,20.4,91.89,49.71,18,124,142
2011-12-01 07:00:00,3,1,12.49,83.79,8.28,15,41,56
2011-12-01 08:00:00,3,4,18.95,92.12,12.58,17,48,65
2011-12-01 09:00:00,2,2,21.91,37.14,8.16,15,29,44
2011-12-01 10:00:00,1,1,35.0,73.45,16.87,47,7,54
2011-12-01 11:00:00,3,3,24.33,79.08,14.46,30,164,194
2011-12-01 12:00:00,2,1,25.83,79.39,30.06,24,84,108
2011-12-01 13:00:00,2,3,19.74,60.32,49.82,1,7,8
2011-12-01 14:00:00,1,1,15.63,20.9,2.63,45,190,235
2011-12-01 15:00:00,4,1,29.39,40.91,38.92,27,127,154
2011-12-01 16:00:00,2,3,19.85,45.86,6.4,15,10,25
2011-12-01 17:00:00,4,2,34.84,88.16,0.99,35,120,155
2011-12-01 18:00:00,4,2,18.71,87.27,31.93,44,185,229
2011-12-01 19:00:00,3,2,7.04,28.37,43.67,39,120,159
2011-12-01 20:00:00,4,1,25.48,95.99,8.81,34,161,195
2011-12-01 21:00:00,1,4,6.4,34.6,17.08,23,166,189
2011-12-01 22:00:00,3,1,12.52,53.15,8.44,34,143,177
2011-12-01 23:00:00,3,4,15.61,37.21,45.33,29,70,99
2011-12-02 00:00:00,3,4,27.18,88.83,13.52,36,131,167
2011-12-02 01:00:00,2,2,19.83,79.95,22.24,10,95,105
2011-12-02 02:00:00,2,4,5.86,48.28,44.74,44,100,144
2011-12-02 03:00:00,4,1,23.51,74.55,27.64,33,173,206
2011-12-02 04:00:00,3,1,17.34,34.75,46.64,37,21,58
2011-12-02 05:00:00,3,2,32.66,50.58,46.32,38,198,236
2011-12-02 06:00:00,1,3,19.99,50.17,23.08,23,12,35
2011-12-02 07:00:00,4,1,26.27,39.03,29.12,28,81,109
2011-12-02 08:00:00,1,4,11.57,90.1,11.52,3,169,172
2011-12-02 09:00:00,4,1,27.83,74.31,49.53,40,161,201
2011-12-02 10:00:00,4,1,26.63,42.4,13.92,49,12,61
2011-12-02 11:00:00,2,1,32.12,39.37,39.17,29,156,185
2011-12-02 12:00:00,2,3,6.01,21.44,15.65,13,125,138
2011-12-02 13:00:00,1,4,18.43,47.73,15.65,23,174,197
2011-12-02 14:00:00,4,2,25.37,62.14,5.19,37,196,233
2011-12-02 15:00:00,3,1,7.85,42.22,27.99,33,94,127
2011-12-02 16:00:00,2,4,17.32,76.04,12.24,35,10,45
2011-12-02 17:00:00,3,4,33.26,52.94,7.42,14,62,76
2011-12-02 18:00:00,1,2,18.08,45.31,11.33,34,101,135
2011-12-02 19:00:00,2,1,34.56,95.12,12.55,28,50,78
2011-12-02 20:00:00,2,3,6.71,41.02,25.2,35,187,222
2011-12-02 21:00:00,4,4,26.53,51.86,19.3,3,46,49
2011-12-02 22:00:00,1,2,22.43,50.58,3.77,14,3,17
2011-12-02 23:00:00,4,3,20.02,39.3,26.8,10,6,16
2011-12-03 00:00:00,2,4,34.13,37.4,39.39,48,86,134
2011-12-03 01:00:00,1,1,8.89,44.19,28.71,14,30,44
2011-12-03 02:00:00,2,4,31.88,89.14,48.73,20,117,137
2011-12-03 03:00:00,1,3,25.74,81.37,4.96,34,85,119
2011-12-03 04:00:00,2,3,12.77,74.48,41.06,22,29,51
2011-12-03 05:00:00,3,1,32.05,56.57,25.28,9,156,165
2011-12-03 06:00:00,3,1,17.88,60.62,26.08,3,42,45
2011-12-03 07:00:00,4,2,29.43,41.37,25.95,44,84,128
2011-12-03 08:00:00,3,1,16.67,25.95,16.27,24,149,173
2011-12-03 09:00:00,2,2,30.53,46.48,16.23,1,175,176
2011-12-03 10:00:00,2,3,24.1,59.65,31.59,37,103,140
2011-12-03 11:00:00,3,3,9.23,24.59,2.24,18,175,193
2011-12-03 12:00:00,4,4,24.49,27.06,29.44,23,111,134
2011-12-03 13:00:00,3,4,10.74,41.04,36.23,7,184,191
2011-12-03 14:00:00,1,2,17.36,49.37,17.82,5,149,154
2011-12-03 15:00:00,1,1,10.11,51.47,10.87,19,154,173
2011-12-03 16:00:00,1,1,5.66,29.43,10.67,13,62,75
2011-12-03 17:00:00,3,4,11.36,38.07,4.09,39,3,42
2011-12-03 18:00:00,3,3,21.09,40.93,4.49,5,89,94
2011-12-03 19:00:00,3,2,19.45,25.41,8.33,11,121,132
2011-12-03 20:00:00,1,3,20.04,46.09,0.96,40,2,42
2011-12-03 21:00:00,4,3,12.43,25.78,13.31,6,80,86
2011-12-03 22:00:00,2,1,25.55,76.28,15.32,44,167,211
2011-12-03 23:00:00,3,2,26.13,50.88,49.76,29,82,111
2011-12-04 00:00:00,4,3,15.74,46.14,49.58,15,81,96
2011-12-04 01:00:00,2,4,31.44,30.12,9.35,7,155,162
2011-12-04 02:00:00,2,4,24.32,38.12,10.65,13,116,129
2011-12-04 03:00:00,2,1,26.39,38.62,24.6,47,142,189
2011-12-04 04:00:00,4,4,13.32,98.82,7.44,19,50,69
2011-12-04 05:00:00,4,4,5.02,86.83,25.2,27,153,180
2011-12-04 06:00:00,1,3,30.96,21.22,19.97,5,34,39
2011-12-04 07:00:00,4,4,29.67,69.35,16.23,29,125,154
2011-12-04 08:00:00,4,4,8.7,40.47,41.13,3,79,82
2011-12-04 09:00:00,4,3,16.22,28.35,41.41,35,14,49
2011-12-04 10:00:00,2,1,24.84,76.45,49.39,2,132,134
2011-12-04 11:00:00,3,1,24.56,30.53,11.15,9,173,182
2011-12-04 12:00:00,1,2,30.81,55.5,44.41,37,23,60
2011-12-04 13:00:00,3,4,9.21,70.57,26.89,26,1,27
2011-12-04 14:00:00,3,3,17.9,64.36,29.57,17,186,203
2011-12-04 15:00:00,4,2,7.92,98.21,44.81,44,163,207
2011-12-04 16:00:00,1,1,16.69,82.86,47.13,10,44,54
2011-12-04 17:00:00,3,1,5.45,81.94,36.34,35,94,129
2011-12-04 18:00:00,3,3,31.95,48.45,17.39,39,93,132
2011-12-04 19:00:00,1,2,20.81,20.67,24.48,34,122,156
2011-12-04 20:00:00,4,2,30.49,78.75,30.75,43,36,79
2011-12-04 21:00:00,3,3,6.8,99.98,41.43,12,117,129
2011-12-04 22:00:00,2,3,11.82,52.47,32.9,22,184,206
2011-12-04 23:00:00,3,2,12.78,98.84,18.27,42,84,126
2011-12-05 00:00:00,2,1,16.6,31.34,20.89,8,139,147
2011-12-05 01:00:00,4,4,29.09,43.72,2.52,3,121,124
2011-12-05 02:00:00,3,1,16.6,33.66,46.21,42,162,204
2011-12-05 03:00:00,1,3,11.14,58.01,4.41,39,149,188
2011-12-05 04:00:00,1,2,6.95,83.76,29.0,49,116,165
2011-12-05 05:00:00,3,2,7.38,47.25,43.58,30,71,101
2011-12-05 06:00:00,4,4,27.8,92.5,21.04,2,154,156
2011-12-05 07:00:00,4,2,18.34,63.59,40.01,35,99,134
2011-12-05 08:00:00,1,4,26.79,57.23,40.19,16,6,22
2011-12-05 09:00:00,3,1,25.47,82.96,2.99,15,2,17
2011-12-05 10:00:00,4,1,9.06,28.12,20.61,38,3,41
2011-12-05 11:00:00,1,2,9.29,81.9,34.55,1,7,8
2011-12-05 12:00:00,2,2,27.66,39.44,21.12,4,44,48
2011-12-05 13:00:00,3,3,26.64,42.47,27.26,32,147,179
2011-12-05 14:00:00,2,3,16.34,67.96,29.72,12,132,144
2011-12-05 15:00:00,2,2,7.32,92.15,7.56,11,173,184
2011-12-05 16:00:00,4,2,5.36,66.27,20.6,18,68,86
2011-12-05 17:00:00,4,1,13.64,71.92,1.42,21,34,55
2011-12-05 18:00:00,4,2,5.28,82.13,7.48,39,192,231
2011-12-05 19:00:00,3,3,11.9,40.75,25.61,7,142,149
2011-12-05 20:00:00,2,1,17.59,86.18,28.68,43,16,59
2011-12-05 21:00:00,3,4,8.64,53.44,7.31,3,75,78
2011-12-05 22:00:00,4,3,8.13,34.05,37.78,6,173,179
2011-12-05 23:00:00,2,3,31.89,48.01,18.65,47,188,235
2011-12-06 00:00:00,3,1,22.56,39.69,46.03,21,170,191
2011-12-06 01:00:00,3,4,33.03,38.3,19.38,17,121,138
2011-12-06 02:00:00,1,3,15.37,42.61,7.49,5,78,83
2011-12-06 03:00:00,3,2,25.31,34.47,37.9,49,90,139
2011-12-06 04:00:00,4,3,11.14,73.42,28.39,3,113,116
2011-12-06 05:00:00,3,1,23.55,66.4,19.33,40,21,61
2011-12-06 06:00:00,2,1,8.89,71.88,17.8,44,136,180
2011-12-06 07:00:00,3,1,5.06,47.5,7.54,11,46,57
2011-12-06 08:00:00,1,3,32.95,81.58,17.04,47,2,49
2011-12-06 09:00:00,2,4,21.65,30.37,1.47,36,179,215
2011-12-06 10:00:00,2,2,32.81,65.69,25.12,1,30,31
2011-12-06 11:00:00,1,1,15.01,42.04,44.84,2,12,14
2011-12-06 12:00:00,4,4,14.83,62.21,39.77,44,1,45
2011-12-06 13:00:00,2,2,17.02,45.89,1.43,20,110,130
2011-12-06 14:00:00,4,1,26.18,83.24,44.06,38,6,44
2011-12-06 15:00:00,2,2,21.97,91.3,22.62,12,28,40
2011-12-06 16:00:00,2,2,32.76,79.41,9.54,47,131,178
2011-12-06 17:00:00,4,4,5.76,34.05,37.62,13,131,144
2011-12-06 18:00:00,2,2,26.25,41.99,16.14,29,87,116
2011-12-06 19:00:00,4,1,14.91,93.55,12.67,17,148,165
2011-12-06 20:00:00,1,4,10.41,54.98,8.07,12,172,184
2011-12-06 21:00:00,4,3,20.31,95.29,24.33,13,126,139
2011-12-06 22:00:00,1,3,20.15,51.4,4.67,40,155,195
2011-12-06 23:00:00,2,4,9.11,96.14,39.28,39,7,46
2011-12-07 00:00:00,4,3,11.06,94.06,23.53,24,41,65
2011-12-07 01:00:00,2,2,17.24,72.84,22.35,36,144,180
2011-12-07 02:00:00,4,1,17.26,20.71,0.09,26,136,162
2011-12-07 03:00:00,1,2,14.53,52.03,40.89,22,188,210
2011-12-07 04:00:00,1,4,9.46,92.9,24.64,6,83,89
2011-12-07 05:00:00,4,1,5.13,90.81,21.99,47,68,115
2011-12-07 06:00:00,1,4,34.11,34.99,38.07,9,98,107
2011-12-07 07:00:00,2,4,33.3,51.93,3.14,24,40,64
2011-12-07 08:00:00,2,4,19.51,86.84,18.33,34,156,190
2011-12-07 09:00:00,3,2,34.85,66.23,28.79,23,53,76
2011-12-07 10:00:00,1,1,25.21,87.78,23.03,48,159,207
2011-12-07 11:00:00,2,1,7.07,86.13,9.08,41,192,233
2011-12-07 12:00:00,4,1,8.53,92.6,14.96,10,120,130
2011-12-07 13:00:00,1,2,32.48,29.38,15.01,19,42,61
2011-12-07 14:00:00,2,3,23.9,31.62,49.6,9,68,77
2011-12-07 15:00:00,1,2,30.3,26.62,16.31,49,114,163
2011-12-07 16:00:00,4,2,31.95,94.82,10.26,20,99,119
2011-12-07 17:00:00,2,4,18.44,58.01,41.13,27,15,42
2011-12-07 18:00:00,3,1,6.46,25.15,21.06,27,148,175
2011-12-07 19:00:00,3,1,10.65,45.72,22.19,26,160,186
2011-12-07 20:00:00,1,3,7.0,48.11,27.44,32,153,185
2011-12-07 21:00:00,4,3,10.66,84.76,29.78,3,130,133
2011-12-07 22:00:00,2,4,17.32,78.84,29.53,34,22,56
2011-12-07 23:00:00,4,1,8.55,75.15,1.72,19,88,107
2011-12-08 00:00:00,2,3,10.0,21.75,40.94,5,181,186
2011-12-08 01:00:00,1,3,18.37,92.86,9.74,5,83,88
2011-12-08 02:00:00,2,1,15.21,37.24,14.62,16,46,62
2011-12-08 03:00:00,4,2,19.03,70.32,8.67,18,117,135
2011-12-08 04:00:00,4,3,17.88,24.95,38.35,48,163,211
2011-12-08 05:00:00,1,1,24.33,26.52,29.18,16,34,50
2011-12-08 06:00:00,4,3,33.12,20.77,37.76,48,170,218
2011-12-08 07:00:00,2,4,8.24,65.27,32.67,2,160,162
2011-12-08 08:00:00,1,3,7.98,70.35,5.21,45,4,49
2011-12-08 09:00:00,2,1,30.58,24.04,15.07,33,3,36
2011-12-08 10:00:00,4,3,20.19,43.24,25.36,3,57,60
2011-12-08 11:00:00,1,4,27.99,88.12,15.25,22,179,201
2011-12-08 12:00:00,2,4,11.46,28.1,10.37,17,199,216
2011-12-08 13:00:00,4,3,29.87,37.32,43.49,33,106,139
2011-12-08 14:00:00,4,3,32.72,53.95,37.39,28,177,205
2011-12-08 15:00:00,3,4,24.06,87.38,17.26,43,154,197
2011-12-08 16:00:00,4,4,8.18,40.39,38.25,14,137,151
2011-12-08 17:00:00,2,2,31.86,99.77,31.38,44,122,166
2011-12-08 18:00:00,1,2,28.77,48.42,0.19,10,61,71
2011-12-08 19:00:00,3,4,27.53,50.92,19.01,38,121,159
2011-12-08 20:00:00,4,3,6.1,29.77,14.52,8,147,155
2011-12-08 21:00:00,4,1,28.97,74.42,10.9,46,31,77
2011-12-08 22:00:00,4,3,9.14,39.48,12.58,34,47,81
2011-12-08 23:00:00,2,3,11.67,70.31,47.12,9,176,185
2011-12-09 00:00:00,3,2,22.31,37.85,24.32,39,25,64
2011-12-09 01:00:00,2,2,12.95,51.03,42.39,37,121,158
2011-12-09 02:00:00,3,2,24.84,88.53,10.71,28,162,190
2011-12-09 03:00:00,1,4,23.24,79.11,8.72,45,27,72
2011-12-09 04:00:00,2,4,8.24,32.37,44.44,5,64,69
2011-12-09 05:00:00,2,3,24.68,68.62,24.79,18,118,136
2011-12-09 06:00:00,1,3,32.72,70.29,44.76,25,153,178
2011-12-09 07:00:00,3,1,9.83,27.25,3.15,8,185,193
2011-12-09 08:00:00,4,3,22.91,57.26,45.82,40,5,45
2011-12-09 09:00:00,1,3,15.26,40.85,20.77,47,49,96
2011-12-09 10:00:00,4,2,18.79,57.37,7.77,44,48,92
2011-12-09 11:00:00,4,2,13.61,82.17,34.17,12,185,197
2011-12-09 12:00:00,1,2,15.62,32.66,39.85,25,45,70
2011-12-09 13:00:00,3,2,5.87,29.86,2.37,43,89,132
2011-12-09 14:00:00,4,2,34.45,41.55,49.36,19,148,167
2011-12-09 15:00:00,1,1,23.74,96.18,34.85,1,95,96
2011-12-09 16:00:00,2,1,20.02,79.83,16.07,3,24,27
2011-12-09 17:00:00,2,1,16.51,21.56,7.56,6,95,101
2011-12-09 18:00:00,2,2,21.18,52.08,19.63,18,124,142
2011-12-09 19:00:00,1,4,16.4,40.59,11.03,34,104,138
2011-12-09 20:00:00,2,2,15.8,71.05,24.71,10,62,72
2011-12-09 21:00:00,4,2,18.92,56.74,39.09,18,82,100
2011-12-09 22:00:00,2,1,13.28,97.16,33.01,31,65,96
2011-12-09 23:00:00,2,2,10.4,37.52,21.8,13,162,175
2011-12-10 00:00:00,4,1,21.7,67.03,5.95,48,79,127
2011-12-10 01:00:00,2,2,30.28,76.02,47.86,4,32,36
2011-12-10 02:00:00,4,3,9.58,86.05,13.52,24,49,73
2011-12-10 03:00:00,2,4,5.98,52.56,13.89,13,151,164
2011-12-10 04:00:00,4,4,12.4,74.95,32.28,38,94,132
2011-12-10 05:00:00,2,1,34.39,44.26,38.53,11,150,161
2011-12-10 06:00:00,4,3,29.86,54.84,49.21,48,80,128
2011-12-10 07:00:00,1,4,22.88,91.65,48.46,19,96,115
2011-12-10 08:00:00,4,1,32.88,95.99,45.69,17,36,53
2011-12-10 09:00:00,2,2,18.36,77.51,21.77,0,99,99
2011-12-10 10:00:00,2,2,34.5,49.95,8.33,42,62,104
2011-12-10 11:00:00,3,3,13.89,85.6,29.22,3,183,186
2011-12-10 12:00:00,4,4,12.21,22.07,0.86,11,62,73
2011-12-10 13:00:00,1,2,24.14,28.22,9.81,25,18,43
2011-12-10 14:00:00,4,1,16.34,72.91,0.13,31,148,179
2011-12-10 15:00:00,4,2,23.79,43.3,9.03,36,38,74
2011-12-10 16:00:00,1,2,14.15,96.11,23.74,14,103,117
2011-12-10 17:00:00,4,4,23.54,54.88,19.67,34,82,116
2011-12-10 18:00:00,1,4,13.27,54.35,18.46,25,199,224
2011-12-10 19:00:00,1,1,6.53,74.25,41.55,14,153,167
2011-12-10 20:00:00,4,3,32.36,81.41,33.75,7,104,111
2011-12-10 21:00:00,4,3,31.5,58.04,46.82,27,178,205
2011-12-10 22:00:00,2,2,34.12,37.12,22.27,29,59,88
2011-12-10 23:00:00,2,1,26.5,81.86,13.61,42,81,123
2011-12-11 00:00:00,3,3,25.48,45.63,6.13,43,91,134
2011-12-11 01:00:00,3,3,21.77,34.01,33.6,2,121,123
2011-12-11 02:00:00,4,2,8.78,70.53,42.09,5,123,128
2011-12-11 03:00:00,1,1,10.68,27.24,9.19,30,96,126
2011-12-11 04:00:00,3,3,13.68,97.71,43.94,25,133,158
2011-12-11 05:00:00,4,4,31.7,70.59,26.31,7,134,141
2011-12-11 06:00:00,3,4,10.19,98.87,7.2,38,187,225
2011-12-11 07:00:00,1,2,32.69,47.11,32.14,28,188,216
2011-12-11 08:00:00,4,2,20.68,97.7,26.0,16,132,148
2011-12-11 09:00:00,1,2,26.47,31.64,1.41,15,90,105
2011-12-11 10:00:00,4,2,8.31,23.26,19.96,48,135,183
2011-12-11 11:00:00,3,3,13.07,22.64,39.24,44,101,145
2011-12-11 12:00:00,2,1,33.76,57.19,27.77,3,160,163
2011-12-11 13:00:00,3,2,12.98,26.64,14.1,9,184,193
2011-12-11 14:00:00,3,2,13.9,60.97,46.43,15,139,154
2011-12-11 15:00:00,2,3,10.93,46.2,11.89,18,100,118
2011-12-11 16:00:00,2,2,8.87,46.85,12.64,38,124,162
2011-12-11 17:00:00,4,2,12.0,70.85,17.73,49,36,85
2011-12-11 18:00:00,4,1,24.27,33.05,44.73,12,142,154
2011-12-11 19:00:00,1,4,18.66,81.32,25.38,3,16,19
2011-12-11 20:00:00,1,2,21.61,66.56,34.11,31,36,67
2011-12-11 21:00:00,3,3,8.67,93.2,48.81,17,178,195
2011-12-11 22:00:00,2,1,29.06,49.19,39.16,15,156,171
2011-12-11 23:00:00,1,3,28.52,98.62,8.63,24,2,26
2011-12-12 00:00:00,3,1,5.65,66.07,39.42,49,153,202
2011-12-12 01:00:00,2,1,16.51,97.87,37.42,15,103,118
2011-12-12 02:00:00,4,2,7.06,22.16,11.63,21,120,141
2011-12-12 03:00:00,3,2,28.76,78.24,16.27,23,44,67
2011-12-12 04:00:00,4,2,27.12,85.33,35.51,27,133,160
2011-12-12 05:00:00,1,4,32.06,24.25,11.92,22,98,120
2011-12-12 06:00:00,1,4,12.09,66.32,10.41,20,181,201
2011-12-12 07:00:00,2,3,18.69,84.16,35.17,8,146,154
2011-12-12 08:00:00,3,2,10.53,64.88,44.03,1,12,13
2011-12-12 09:00:00,4,4,16.14,25.11,3.75,37,56,93
2011-12-12 10:00:00,2,2,20.67,75.48,22.3,27,72,99
2011-12-12 11:00:00,1,4,6.6,24.85,30.36,25,82,107
2011-12-12 12:00:00,1,4,26.45,85.4,33.81,26,84,110
2011-12-12 13:00:00,3,1,21.3,23.44,49.81,24,184,208
2011-12-12 14:00:00,4,2,29.87,30.99,34.13,20,173,193
2011-12-12 15:00:00,3,2,13.15,42.01,31.01,37,11,48
2011-12-12 16:00:00,4,4,32.1,70.67,49.49,24,156,180
2011-12-12 17:00:00,4,2,34.96,98.11,3.03,37,96,133
2011-12-12 18:00:00,3,4,32.58,29.43,3.72,45,64,109
2011-12-12 19:00:00,2,2,28.34,31.42,28.03,10,48,58
2011-12-12 20:00:00,3,1,29.37,49.51,17.93,27,126,153
2011-12-12 21:00:00,3,2,22.21,86.9,4.83,48,131,179
2011-12-12 22:00:00,1,1,10.7,57.38,15.32,35,27,62
2011-12-12 23:00:00,1,3,25.31,45.73,33.72,3,49,52
2011-12-13 00:00:00,3,2,26.38,64.9,44.03,18,11,29
2011-12-13 01:00:00,3,2,34.56,40.84,4.72,23,82,105
2011-12-13 02:00:00,1,2,21.24,52.09,27.01,21,17,38
2011-12-13 03:00:00,4,1,13.14,46.61,14.81,47,106,153
2011-12-13 04:00:00,3,2,25.51,84.33,33.37,24,110,134
2011-12-13 05:00:00,2,2,34.38,93.94,27.47,7,110,117
2011-12-13 06:00:00,2,4,10.32,80.77,46.34,19,133,152
2011-12-13 07:00:00,2,3,14.78,55.13,1.88,0,67,67
2011-12-13 08:00:00,3,1,21.26,60.35,23.5,3,75,78
2011-12-13 09:00:00,4,4,10.11,30.01,9.64,11,22,33
2011-12-13 10:00:00,4,1,5.67,79.75,26.84,24,155,179
2011-12-13 11:00:00,1,4,15.11,67.72,42.68,20,39,59
2011-12-13 12:00:00,3,3,30.96,92.2,45.57,18,97,115
2011-12-13 13:00:00,4,4,6.3,36.05,19.91,33,47,80
2011-12-13 14:00:00,3,1,17.87,80.78,40.59,5,161,166
2011-12-13 15:00:00,1,2,27.87,74.77,14.03,34,91,125
2011-12-13 16:00:00,1,2,33.6,41.27,0.32,2,189,191
2011-12-13 17:00:00,1,3,34.56,73.39,42.76,32,185,217
2011-12-13 18:00:00,2,1,17.66,93.95,5.97,8,161,169
2011-12-13 19:00:00,3,1,33.51,93.47,0.88,6,56,62
2011-12-13 20:00:00,1,1,6.06,77.57,17.69,40,28,68
2011-12-13 21:00:00,3,3,27.38,23.85,18.97,26,89,115
2011-12-13 22:00:00,2,2,24.28,89.78,3.86,0,123,123
2011-12-13 23:00:00,2,4,12.49,72.62,40.71,39,179,218
2011-12-14 00:00:00,1,3,20.22,44.83,20.28,17,97,114
2011-12-14 01:00:00,1,4,8.89,34.98,24.5,34,7,41
2011-12-14 02:00:00,4,2,31.15,29.3,13.23,16,92,108
2011-12-14 03:00:00,3,3,15.74,24.02,25.58,38,106,144
2011-12-14 04:00:00,1,2,23.78,80.33,38.34,10,103,113
2011-12-14 05:00:00,4,4,9.76,38.87,45.31,36,143,179
2011-12-14 06:00:00,3,1,11.18,21.94,48.53,44,91,135
2011-12-14 07:00:00,1,1,34.76,51.78,21.34,10,157,167
2011-12-14 08:00:00,4,4,27.59,58.61,49.5,2,86,88
2011-12-14 09:00:00,4,1,33.86,33.54,14.75,12,92,104
2011-12-14 10:00:00,3,4,13.88,23.52,0.35,27,83,110
2011-12-14 11:00:00,4,3,9.94,35.13,38.38,37,80,117
2011-12-14 12:00:00,3,3,20.09,74.33,8.92,46,153,199
2011-12-14 13:00:00,3,3,19.84,26.58,2.62,33,184,217
2011-12-14 14:00:00,3,1,10.25,64.4,46.2,27,38,65
2011-12-14 15:00:00,2,2,27.0,31.71,39.59,1,32,33
2011-12-14 16:00:00,4,1,15.85,35.66,5.13,45,77,122
2011-12-14 17:00:00,3,1,10.59,51.45,38.85,1,30,31
2011-12-14 18:00:00,1,2,14.96,28.07,42.2,36,20,56
2011-12-14 19:00:00,2,2,21.91,33.86,45.27,15,177,192
2011-12-14 20:00:00,2,2,26.79,47.92,27.18,7,127,134
2011-12-14 21:00:00,4,2,19.46,46.37,35.17,39,133,172
2011-12-14 22:00:00,3,1,20.77,79.94,38.11,10,187,197
2011-12-14 23:00:00,4,4,9.17,25.98,34.43,44,89,133
2011-12-15 00:00:00,2,3,32.44,88.84,32.34,14,140,154
2011-12-15 01:00:00,3,4,32.86,85.3,27.38,3,57,60
2011-12-15 02:00:00,1,1,25.5,81.28,23.96,22,171,193
2011-12-15 03:00:00,3,2,5.53,44.75,49.81,7,31,38
2011-12-15 04:00:00,2,3,21.11,85.83,16.88,15,58,73
2011-12-15 05:00:00,1,3,23.88,34.62,4.41,15,102,117
2011-12-15 06:00:00,3,4,34.84,29.95,38.25,23,80,103
2011-12-15 07:00:00,1,1,34.88,23.6,10.69,9,172,181
2011-12-15 08:00:00,1,1,30.73,95.14,26.63,33,182,215
2011-12-15 09:00:00,2,1,6.91,44.64,4.79,17,176,193
2011-12-15 10:00:00,1,3,33.6,93.41,30.96,15,60,75
2011-12-15 11:00:00,4,4,23.38,41.81,47.2,35,39,74
2011-12-15 12:00:00,2,3,29.03,92.61,36.14,7,81,88
2011-12-15 13:00:00,4,3,17.22,92.31,10.73,19,161,180
2011-12-15 14:00:00,1,2,14.59,93.89,48.56,22,112,134
2011-12-15 15:00:00,4,4,18.9,59.69,15.35,39,88,127
2011-12-15 16:00:00,3,2,9.41,89.28,21.83,13,11,24
2011-12-15 17:00:00,1,1,15.71,96.06,24.91,15,142,157
2011-12-15 18:00:00,3,3,30.73,45.97,49.54,37,106,143
2011-12-15 19:00:00,4,4,6.14,53.51,3.44,17,8,25
2011-12-15 20:00:00,3,1,9.53,77.54,34.84,39,147,186
2011-12-15 21:00:00,1,4,8.75,44.03,18.1,29,88,117
2011-12-15 22:00:00,3,3,17.09,80.3,3.92,35,110,145
2011-12-15 23:00:00,4,4,34.91,25.91,46.75,35,48,83
2011-12-16 00:00:00,4,1,10.2,61.88,29.49,38,13,51
2011-12-16 01:00:00,4,2,9.36,29.79,37.68,39,132,171
2011-12-16 02:00:00,1,3,32.45,43.47,12.02,40,125,165
2011-12-16 03:00:00,4,2,31.46,40.69,38.08,0,47,47
2011-12-16 04:00:00,1,3,5.97,87.11,41.42,16,56,72
2011-12-16 05:00:00,3,1,27.55,35.48,21.54,27,92,119
2011-12-16 06:00:00,4,3,24.66,84.68,28.6,6,59,65
2011-12-16 07:00:00,3,2,28.03,83.52,48.59,19,199,218
2011-12-16 08:00:00,2,3,19.84,59.91,42.34,41,80,121
2011-12-16 09:00:00,3,1,34.74,38.71,22.24,23,42,65
2011-12-16 10:00:00,2,3,6.32,38.15,33.23,0,81,81
2011-12-16 11:00:00,3,2,12.03,57.19,39.21,17,90,107
2011-12-16 12:00:00,1,1,16.9,20.7,1.22,25,63,88
2011-12-16 13:00:00,3,2,18.49,62.51,29.42,13,1,14
2011-12-16 14:00:00,1,3,32.64,96.22,49.23,18,0,18
2011-12-16 15:00:00,1,4,21.8,32.38,47.36,17,117,134
2011-12-16 16:00:00,4,2,6.35,65.87,41.62,44,63,107
2011-12-16 17:00:00,1,3,17.24,96.94,5.31,6,71,77
2011-12-16 18:00:00,2,4,17.49,88.84,49.7,1,84,85
2011-12-16 19:00:00,4,4,33.96,88.03,30.48,6,23,29
2011-12-16 20:00:00,4,1,22.98,85.75,11.15,27,129,156
2011-12-16 21:00:00,3,4,24.07,44.72,33.71,27,58,85
2011-12-16 22:00:00,1,2,26.4,91.25,42.83,41,101,142
2011-12-16 23:00:00,1,2,28.1,95.31,5.62,16,161,177
2011-12-17 00:00:00,2,4,24.05,59.66,45.82,29,55,84
2011-12-17 01:00:00,3,3,12.12,48.37,46.01,20,113,133
2011-12-17 02:00:00,3,2,31.22,53.14,0.67,36,4,40
2011-12-17 03:00:00,4,2,26.96,46.74,45.02,8,108,116
2011-12-17 04:00:00,4,1,27.26,36.99,47.34,35,123,158
2011-12-17 05:00:00,4,3,34.9,69.48,1.88,21,182,203
2011-12-17 06:00:00,2,4,29.08,65.01,14.71,14,118,132
2011-12-17 07:00:00,2,3,29.87,57.01,18.66,13,35,48
2011-12-17 08:00:00,4,1,33.54,27.67,17.44,26,71,97
2011-12-17 09:00:00,3,1,9.53,83.75,37.95,17,93,110
2011-12-17 10:00:00,2,3,19.93,33.99,17.91,9,182,191
2011-12-17 11:00:00,3,1,22.42,29.16,47.83,47,137,184
2011-12-17 12:00:00,3,1,14.88,69.85,49.75,21,84,105
2011-12-17 13:00:00,1,1,30.18,51.89,15.84,22,173,195
2011-12-17 14:00:00,4,3,27.87,24.78,25.44,41,51,92
2011-12-17 15:00:00,1,1,26.63,48.45,27.89,40,189,229
2011-12-17 16:00:00,4,4,34.91,81.74,28.97,47,131,178
2011-12-17 17:00:00,4,4,12.78,69.22,18.71,4,183,187
2011-12-17 18:00:00,3,2,27.06,49.02,8.3,24,10,34
2011-12-17 19:00:00,4,4,21.54,35.34,2.73,0,104,104
2011-12-17 20:00:00,3,2,14.39,70.54,5.32,23,177,200
2011-12-17 21:00:00,3,3,9.82,91.0,45.06,32,188,220
2011-12-17 22:00:00,4,1,31.88,71.7,14.02,36,150,186
2011-12-17 23:00:00,3,4,22.86,85.03,3.84,6,125,131
2011-12-18 00:00:00,3,2,29.75,61.72,31.18,23,112,135
2011-12-18 01:00:00,3,3,21.36,77.44,3.77,14,29,43
2011-12-18 02:00:00,2,2,11.6,91.7,3.5,10,122,132
2011-12-18 03:00:00,3,1,15.13,81.85,31.08,43,87,130
2011-12-18 04:00:00,2,4,16.45,92.79,29.57,16,24,40
2011-12-18 05:00:00,2,3,34.19,54.49,2.07,48,29,77
2011-12-18 06:00:00,3,2,5.17,92.34,23.02,22,166,188
2011-12-18 07:00:00,3,3,34.57,69.73,21.79,48,73,121
2011-12-18 08:00:00,2,2,34.41,89.6,27.33,3,123,126
2011-12-18 09:00:00,2,2,34.88,23.15,36.89,30,138,168
2011-12-18 10:00:00,3,1,19.3,72.63,14.14,33,72,105
2011-12-18 11:00:00,3,1,33.91,87.84,21.64,9,163,172
2011-12-18 12:00:00,4,2,16.87,33.94,39.64,36,111,147
2011-12-18 13:00:00,2,4,5.79,72.94,46.13,9,179,188
2011-12-18 14:00:00,2,3,11.73,86.0,44.57,41,4,45
2011-12-18 15:00:00,4,3,33.36,43.04,23.88,10,75,85
2011-12-18 16:00:00,2,1,5.41,52.42,26.04,30,141,171
2011-12-18 17:00:00,1,4,21.38,65.56,26.46,9,147,156
2011-12-18 18:00:00,2,2,7.27,61.53,43.44,42,19,61
2011-12-18 19:00:00,4,1,13.59,23.14,42.0,37,171,208
2011-12-18 20:00:00,1,2,7.64,27.89,15.58,41,99,140
2011-12-18 21:00:00,3,2,30.79,28.04,8.14,7,24,31
2011-12-18 22:00:00,4,1,22.73,40.98,18.95,10,168,178
2011-12-18 23:00:00,4,4,32.06,39.67,14.42,19,109,128
2011-12-19 00:00:00,3,3,25.65,79.38,47.54,23,126,149
2011-12-19 01:00:00,4,1,34.13,65.82,13.3,6,68,74
2011-12-19 02:00:00,2,4,20.3,81.12,9.06,20,90,110
2011-12-19 03:00:00,3,2,24.16,25.59,44.97,43,1,44
2011-12-19 04:00:00,4,1,22.29,58.82,4.32,5,139,144
2011-12-19 05:00:00,3,3,19.53,45.9,13.01,30,27,57
2011-12-19 06:00:00,3,3,30.38,88.0,21.96,11,43,54
2011-12-19 07:00:00,3,2,24.34,76.62,29.76,36,140,176
2011-12-19 08:00:00,1,1,29.04,89.54,16.38,12,84,96
2011-12-19 09:00:00,4,3,28.59,23.71,24.81,48,42,90
2011-12-19 10:00:00,1,1,10.73,77.67,9.94,30,54,84
2011-12-19 11:00:00,4,3,24.5,63.2,28.71,8,135,143
2011-12-19 12:00:00,2,2,10.99,86.0,20.39,26,123,149
2011-12-19 13:00:00,2,2,22.5,60.57,42.46,16,63,79
2011-12-19 14:00:00,2,1,25.32,63.22,20.79,7,116,123
2011-12-19 15:00:00,4,4,34.92,24.14,22.19,26,11,37
2011-12-19 16:00:00,3,4,5.92,73.48,29.61,39,40,79
2011-12-19 17:00:00,3,2,7.74,41.85,6.16,14,43,57
2011-12-19 18:00:00,1,3,7.31,21.58,7.84,38,10,48
2011-12-19 19:00:00,1,4,16.95,25.31,39.51,5,18,23
2011-12-19 20:00:00,2,2,29.65,96.58,13.67,31,124,155
2011-12-19 21:00:00,1,3,30.32,47.69,34.23,47,59,106
2011-12-19 22:00:00,4,3,27.11,89.45,4.87,7,199,206
2011-12-19 23:00:00,4,4,31.91,96.77,41.09,34,154,188
2011-12-20 00:00:00,1,2,14.69,95.46,49.41,30,198,228
2011-12-20 01:00:00,1,3,7.64,90.54,18.68,41,120,161
2011-12-20 02:00:00,1,3,6.74,91.59,25.28,25,154,179
2011-12-20 03:00:00,1,1,30.56,43.12,22.14,41,13,54
2011-12-20 04:00:00,2,1,26.91,32.12,44.71,23,151,174
2011-12-20 05:00:00,2,4,25.96,71.14,0.5,1,63,64
2011-12-20 06:00:00,1,1,15.19,59.05,32.67,40,151,191
2011-12-20 07:00:00,4,2,16.4,27.9,32.62,0,129,129
2011-12-20 08:00:00,2,4,33.74,74.2,19.12,9,179,188
2011-12-20 09:00:00,4,4,6.91,65.03,10.97,49,94,143
2011-12-20 10:00:00,3,1,28.21,89.05,11.98,22,11,33
2011-12-20 11:00:00,4,3,14.29,68.73,40.02,32,192,224
2011-12-20 12:00:00,1,2,6.17,65.92,3.31,43,187,230
2011-12-20 13:00:00,3,2,27.28,55.26,28.19,36,57,93
2011-12-20 14:00:00,2,2,14.93,57.02,15.34,10,93,103
2011-12-20 15:00:00,2,4,26.66,96.35,13.26,19,41,60
2011-12-20 16:00:00,3,2,26.23,31.08,25.29,25,0,25
2011-12-20 17:00:00,4,3,21.04,55.7,44.89,45,149,194
2011-12-20 18:00:00,2,3,28.32,72.47,30.9,46,105,151
2011-12-20 19:00:00,1,1,22.43,54.64,39.43,1,71,72
2011-12-20 20:00:00,3,2,13.6,42.66,30.03,24,140,164
2011-12-20 21:00:00,1,4,27.02,42.99,34.89,3,192,195
2011-12-20 22:00:00,3,1,22.67,38.69,21.62,18,37,55
2011-12-20 23:00:00,2,3,5.38,47.51,46.3,12,191,203
2011-12-21 00:00:00,4,2,32.05,89.73,25.1,18,75,93
2011-12-21 01:00:00,3,3,21.37,60.42,27.59,12,51,63
2011-12-21 02:00:00,3,1,31.06,39.22,26.25,11,110,121
2011-12-21 03:00:00,1,3,31.48,50.76,15.81,1,79,80
2011-12-21 04:00:00,2,2,18.35,28.47,11.56,36,83,119
2011-12-21 05:00:00,1,2,20.23,92.32,3.69,49,107,156
2011-12-21 06:00:00,2,1,17.47,52.66,35.91,22,159,181
2011-12-21 07:00:00,1,2,18.48,98.43,14.46,18,154,172
2011-12-21 08:00:00,3,3,31.85,47.8,19.46,2,97,99
2011-12-21 09:00:00,1,3,28.64,86.91,46.0,23,188,211
2011-12-21 10:00:00,4,4,8.8,40.51,28.32,22,85,107
2011-12-21 11:00:00,2,4,23.31,26.09,4.85,3,61,64
2011-12-21 12:00:00,2,4,34.88,22.54,39.98,17,2,19
2011-12-21 13:00:00,3,3,22.87,68.49,12.81,11,80,91
2011-12-21 14:00:00,2,3,28.58,44.93,27.64,34,125,159
2011-12-21 15:00:00,4,1,28.07,55.48,25.5,26,90,116
2011-12-21 16:00:00,1,4,15.51,85.49,11.9,42,102,144
2011-12-21 17:00:00,3,3,16.16,39.85,5.79,13,109,122
2011-12-21 18:00:00,4,1,26.72,44.69,10.56,30,94,124
2011-12-21 19:00:00,2,3,20.0,87.63,4.87,2,30,32
2011-12-21 20:00:00,2,1,22.12,59.42,13.78,4,191,195
2011-12-21 21:00:00,4,4,26.39,86.21,49.86,28,169,197
2011-12-21 22:00:00,1,4,28.33,49.96,20.1,38,57,95
2011-12-21 23:00:00,1,4,13.15,51.87,43.19,16,42,58
2011-12-22 00:00:00,3,3,9.4,33.37,27.46,18,159,177
2011-12-22 01:00:00,2,3,13.75,93.31,33.33,34,157,191
2011-12-22 02:00:00,4,1,20.23,91.74,7.82,32,82,114
2011-12-22 03:00:00,1,2,15.26,98.74,13.74,7,126,133
2011-12-22 04:00:00,3,2,22.05,52.2,25.52,36,188,224
2011-12-22 05:00:00,2,4,6.6,85.49,44.06,34,155,189
2011-12-22 06:00:00,2,2,20.29,53.2,2.14,19,44,63
2011-12-22 07:00:00,3,4,16.04,56.34,25.35,16,137,153
2011-12-22 08:00:00,3,1,21.04,86.4,2.55,44,143,187
2011-12-22 09:00:00,1,2,17.68,34.19,22.84,12,158,170
2011-12-22 10:00:00,4,2,13.53,37.62,31.44,3,9,12
2011-12-22 11:00:00,2,4,32.12,45.18,37.24,49,73,122
2011-12-22 12:00:00,4,1,10.54,83.05,6.93,29,91,120
2011-12-22 13:00:00,2,2,25.44,49.81,8.33,5,11,16
2011-12-22 14:00:00,2,2,32.74,48.65,23.5,1,155,156
2011-12-22 15:00:00,4,2,21.16,99.91,49.9,14,17,31
2011-12-22 16:00:00,3,1,31.29,50.7,17.8,33,179,212
2011-12-22 17:00:00,1,1,8.75,39.82,21.38,19,155,174
2011-12-22 18:00:00,2,2,19.81,69.86,21.62,15,27,42
2011-12-22 19:00:00,3,4,18.71,84.15,4.04,42,191,233
2011-12-22 20:00:00,2,4,5.24,25.57,38.71,48,13,61
2011-12-22 21:00:00,1,2,18.3,69.51,12.66,28,7,35
2011-12-22 22:00:00,2,1,16.07,22.86,35.18,26,99,125
2011-12-22 23:00:00,1,2,25.09,62.11,23.75,0,2,2
2011-12-23 00:00:00,1,1,33.15,40.56,30.59,12,136,148
2011-12-23 01:00:00,2,2,7.57,44.53,2.7,39,46,85
2011-12-23 02:00:00,2,1,14.82,57.37,44.5,31,62,93
2011-12-23 03:00:00,1,3,18.32,94.17,12.19,2,167,169
2011-12-23 04:00:00,3,4,18.66,76.85,33.5,13,76,89
2011-12-23 05:00:00,4,3,28.24,94.95,39.9,27,85,112
2011-12-23 06:00:00,1,4,18.3,72.8,27.0,45,120,165
2011-12-23 07:00:00,2,1,5.81,20.57,16.87,25,151,176
2011-12-23 08:00:00,2,3,26.3,41.25,48.9,20,198,218
2011-12-23 09:00:00,3,4,31.54,92.46,13.92,45,12,57
2011-12-23 10:00:00,4,2,20.42,71.48,47.43,10,133,143
2011-12-23 11:00:00,1,1,22.43,98.53,7.81,26,178,204
2011-12-23 12:00:00,1,1,9.89,32.48,19.46,43,59,102
2011-12-23 13:00:00,4,2,11.62,43.74,6.92,0,74,74
2011-12-23 14:00:00,1,2,12.06,48.99,0.11,32,156,188
2011-12-23 15:00:00,4,4,17.92,46.12,13.01,45,15,60
2011-12-23 16:00:00,2,1,32.84,40.16,4.36,17,191,208
2011-12-23 17:00:00,4,4,20.65,55.48,49.32,1,84,85
2011-12-23 18:00:00,1,2,10.76,71.38,38.08,3,54,57
2011-12-23 19:00:00,4,1,12.98,44.9,0.19,49,156,205
2011-12-23 20:00:00,3,2,16.52,26.38,11.18,3,77,80
2011-12-23 21:00:00,2,4,23.7,76.68,33.51,16,54,70
2011-12-23 22:00:00,2,4,18.2,56.72,19.93,47,187,234
2011-12-23 23:00:00,4,4,16.77,64.52,41.59,15,168,183
2011-12-24 00:00:00,1,1,21.94,56.43,25.24,8,8,16
2011-12-24 01:00:00,3,2,12.26,91.23,32.68,25,5,30
2011-12-24 02:00:00,2,2,7.37,64.7,29.85,9,101,110
2011-12-24 03:00:00,2,4,5.73,93.86,31.91,6,156,162
2011-12-24 04:00:00,1,4,12.54,60.85,11.5,8,145,153
2011-12-24 05:00:00,1,4,7.75,43.41,18.66,47,23,70
2011-12-24 06:00:00,3,4,15.09,48.44,2.53,26,50,76
2011-12-24 07:00:00,4,3,28.19,61.77,29.38,31,16,47
2011-12-24 08:00:00,1,3,26.49,62.4,22.96,48,20,68
2011-12-24 09:00:00,4,3,23.33,74.99,38.04,22,82,104
2011-12-24 10:00:00,3,4,30.58,37.96,10.32,26,61,87
2011-12-24 11:00:00,4,4,13.46,72.71,21.84,24,90,114
2011-12-24 12:00:00,2,2,31.55,82.29,9.04,28,116,144
2011-12-24 13:00:00,4,1,16.98,74.13,30.7,23,74,97
2011-12-24 14:00:00,3,2,17.03,58.55,42.4,15,116,131
2011-12-24 15:00:00,3,3,17.16,99.33,38.27,15,53,68
2011-12-24 16:00:00,3,2,7.94,52.39,47.21,27,138,165
2011-12-24 17:00:00,4,4,34.26,28.53,48.59,19,170,189
2011-12-24 18:00:00,2,3,9.16,85.72,38.6,18,120,138
2011-12-24 19:00:00,1,3,15.23,36.98,14.34,9,135,144
2011-12-24 20:00:00,2,1,14.58,77.06,10.96,25,150,175
2011-12-24 21:00:00,4,1,7.24,34.32,22.38,1,120,121
2011-12-24 22:00:00,4,3,9.57,21.35,49.69,2,52,54
2011-12-24 23:00:00,1,3,6.35,32.78,20.63,38,39,77
2011-12-25 00:00:00,4,2,13.77,50.16,9.95,1,8,9
2011-12-25 01:00:00,3,3,31.0,28.53,47.22,24,151,175
2011-12-25 02:00:00,3,4,15.18,35.81,19.3,44,75,119
2011-12-25 03:00:00,3,2,8.71,81.17,34.54,3,75,78
2011-12-25 04:00:00,3,4,24.37,81.59,39.41,14,129,143
2011-12-25 05:00:00,3,4,34.9,85.4,42.16,17,69,86
2011-12-25 06:00:00,4,4,11.97,87.29,41.06,6,3,9
2011-12-25 07:00:00,1,3,13.39,53.63,41.81,26,60,86
2011-12-25 08:00:00,1,1,34.16,89.4,33.38,17,125,142
2011-12-25 09:00:00,3,1,10.36,62.07,20.19,6,191,197
2011-12-25 10:00:00,4,4,20.34,57.65,33.36,28,35,63
2011-12-25 11:00:00,2,3,12.19,77.48,41.84,40,40,80
2011-12-25 12:00:00,2,2,32.97,37.11,17.53,43,102,145
2011-12-25 13:00:00,4,4,34.45,83.16,14.83,32,165,197
2011-12-25 14:00:00,3,2,29.44,54.36,17.19,1,81,82
2011-12-25 15:00:00,1,2,14.44,30.18,27.56,17,142,159
2011-12-25 16:00:00,4,3,17.1,29.54,2.62,45,47,92
2011-12-25 17:00:00,2,3,12.27,33.19,38.95,22,96,118
2011-12-25 18:00:00,2,1,31.72,91.25,6.94,5,157,162
2011-12-25 19:00:00,2,1,32.44,99.28,6.64,42,190,232
2011-12-25 20:00:00,3,3,17.57,48.56,9.88,24,24,48
2011-12-25 21:00:00,2,4,24.7,43.37,28.85,18,3,21
2011-12-25 22:00:00,4,1,9.97,37.5,14.28,7,17,24
2011-12-25 23:00:00,4,2,18.05,85.91,18.4,36,172,208
2011-12-26 00:00:00,2,4,23.94,36.74,46.58,25,119,144
2011-12-26 01:00:00,4,2,16.56,93.93,42.36,28,96,124
2011-12-26 02:00:00,2,3,15.73,73.39,42.61,27,83,110
2011-12-26 03:00:00,2,2,5.03,91.77,28.88,6,192,198
2011-12-26 04:00:00,1,4,29.13,64.32,43.32,35,72,107
2011-12-26 05:00:00,3,3,31.68,75.25,38.93,14,64,78
2011-12-26 06:00:00,3,4,34.08,69.56,47.66,32,110,142
2011-12-26 07:00:00,1,2,26.58,86.5,3.22,4,26,30
2011-12-26 08:00:00,1,4,21.46,86.87,1.44,28,87,115
2011-12-26 09:00:00,3,3,13.08,67.18,8.75,16,187,203
2011-12-26 10:00:00,2,2,34.98,70.6,46.45,44,186,230
2011-12-26 11:00:00,2,2,22.69,93.75,30.28,26,152,178
2011-12-26 12:00:00,3,1,25.43,94.39,21.31,16,161,177
2011-12-26 13:00:00,2,1,25.47,73.14,25.64,3,49,52
2011-12-26 14:00:00,1,4,30.36,20.62,41.48,48,182,230
2011-12-26 15:00:00,2,1,5.29,28.35,46.46,11,137,148
2011-12-26 16:00:00,2,1,11.61,88.64,36.48,22,108,130
2011-12-26 17:00:00,4,1,24.97,26.78,37.99,49,185,234
2011-12-26 18:00:00,4,1,31.85,37.08,16.02,10,88,98
2011-12-26 19:00:00,4,3,25.56,38.44,23.35,35,130,165
2011-12-26 20:00:00,2,3,17.4,68.02,44.26,11,85,96
2011-12-26 21:00:00,3,1,15.85,66.13,39.3,8,103,111
2011-12-26 22:00:00,1,4,27.14,43.15,34.21,23,109,132
2011-12-26 23:00:00,2,3,27.24,36.61,3.26,17,119,136
2011-12-27 00:00:00,3,1,23.21,81.16,1.98,26,87,113
2011-12-27 01:00:00,2,3,13.74,94.84,6.52,8,55,63
2011-12-27 02:00:00,1,2,32.75,24.22,29.07,32,154,186
2011-12-27 03:00:00,2,3,21.56,30.65,26.82,5,89,94
2011-12-27 04:00:00,1,3,28.71,71.37,47.13,32,143,175
2011-12-27 05:00:00,2,4,11.43,84.36,34.74,39,37,76
2011-12-27 06:00:00,1,3,15.32,83.3,14.7,5,104,109
2011-12-27 07:00:00,2,4,31.24,77.57,8.07,3,180,183
2011-12-27 08:00:00,1,2,6.5,90.99,42.48,2,195,197
2011-12-27 09:00:00,4,1,20.37,37.39,22.98,12,22,34
2011-12-27 10:00:00,2,4,19.45,28.58,32.67,25,82,107
2011-12-27 11:00:00,2,3,27.54,69.23,28.26,33,183,216
2011-12-27 12:00:00,3,3,13.46,85.78,5.37,12,87,99
2011-12-27 13:00:00,3,4,11.57,66.56,2.85,46,52,98
2011-12-27 14:00:00,1,2,32.78,97.04,18.85,7,199,206
2011-12-27 15:00:00,2,1,22.15,83.65,18.08,11,194,205
2011-12-27 16:00:00,1,3,8.14,76.06,33.69,7,146,153
2011-12-27 17:00:00,4,2,10.79,24.82,31.61,18,3,21
2011-12-27 18:00:00,3,1,34.96,28.62,48.45,40,156,196
2011-12-27 19:00:00,1,1,10.87,82.79,42.9,9,172,181
2011-12-27 20:00:00,1,3,23.31,35.86,24.83,31,104,135
2011-12-27 21:00:00,3,4,17.6,22.31,25.0,20,20,40
2011-12-27 22:00:00,2,3,31.57,92.86,33.71,22,53,75
2011-12-27 23:00:00,1,3,27.66,91.26,5.7,26,125,151
2011-12-28 00:00:00,3,3,22.91,37.48,49.99,24,108,132
2011-12-28 01:00:00,2,2,5.32,82.42,25.94,6,51,57
2011-12-28 02:00:00,4,4,31.39,23.84,45.5,41,145,186
2011-12-28 03:00:00,3,2,18.34,42.8,48.37,34,144,178
2011-12-28 04:00:00,1,3,32.95,69.89,29.08,1,43,44
2011-12-28 05:00:00,4,4,19.87,81.05,5.17,27,106,133
2011-12-28 06:00:00,2,1,25.83,20.83,28.67,6,151,157
2011-12-28 07:00:00,2,4,7.08,46.1,29.88,41,112,153
2011-12-28 08:00:00,3,3,27.35,37.15,39.46,39,133,172
2011-12-28 09:00:00,3,4,15.14,99.9,2.41,11,154,165
2011-12-28 10:00:00,3,1,15.54,73.68,23.32,16,174,190
2011-12-28 11:00:00,2,1,8.56,52.45,46.14,21,173,194
2011-12-28 12:00:00,4,4,9.41,26.05,49.56,8,90,98
2011-12-28 13:00:00,2,1,10.57,67.89,9.57,2,90,92
2011-12-28 14:00:00,1,2,14.85,71.34,43.53,21,162,183
2011-12-28 15:00:00,2,4,31.76,85.31,7.31,35,184,219
2011-12-28 16:00:00,1,1,16.05,43.09,42.06,38,139,177
2011-12-28 17:00:00,4,1,26.73,98.51,13.86,17,28,45
2011-12-28 18:00:00,3,4,7.48,55.16,47.98,16,56,72
2011-12-28 19:00:00,3,2,22.73,43.68,34.77,26,197,223
2011-12-28 20:00:00,2,4,19.46,47.88,19.96,34,54,88
2011-12-28 21:00:00,3,1,34.34,61.57,14.05,31,164,195
2011-12-28 22:00:00,4,4,30.39,94.94,11.76,2,70,72
2011-12-28 23:00:00,3,1,18.64,78.81,34.04,12,197,209
2011-12-29 00:00:00,2,3,28.25,66.17,44.79,16,52,68
2011-12-29 01:00:00,4,4,10.79,33.02,37.75,17,13,30
2011-12-29 02:00:00,1,4,21.87,31.95,41.74,16,20,36
2011-12-29 03:00:00,2,1,7.24,60.18,39.07,47,103,150
2011-12-29 04:00:00,1,1,15.44,78.3,48.96,15,13,28
2011-12-29 05:00:00,4,1,11.78,80.08,37.89,21,52,73
2011-12-29 06:00:00,2,1,26.57,38.07,10.51,24,114,138
2011-12-29 07:00:00,2,4,19.7,28.01,39.58,0,95,95
2011-12-29 08:00:00,4,1,27.53,50.76,16.1,26,126,152
2011-12-29 09:00:00,3,4,20.46,93.45,49.79,13,194,207
2011-12-29 10:00:00,2,2,7.59,63.63,18.83,27,84,111
2011-12-29 11:00:00,2,4,27.06,45.61,14.64,46,93,139
2011-12-29 12:00:00,1,1,30.0,45.89,11.96,35,175,210
2011-12-29 13:00:00,3,1,32.11,30.57,32.93,42,110,152
2011-12-29 14:00:00,1,2,22.16,57.86,5.46,49,183,232
2011-12-29 15:00:00,1,4,27.61,83.31,47.68,31,166,197
2011-12-29 16:00:00,3,2,27.56,97.48,14.72,28,100,128
2011-12-29 17:00:00,3,4,9.67,60.13,14.77,16,168,184
2011-12-29 18:00:00,4,1,9.93,33.38,2.3,27,175,202
2011-12-29 19:00:00,3,4,7.13,74.64,12.3,40,155,195
2011-12-29 20:00:00,2,1,14.6,80.54,20.95,20,1,21
2011-12-29 21:00:00,3,1,19.21,25.74,18.48,23,21,44
2011-12-29 22:00:00,4,3,34.94,88.01,13.65,45,198,243
2011-12-29 23:00:00,4,3,17.93,86.35,2.04,34,127,161
2011-12-30 00:00:00,4,4,26.79,57.8,15.03,19,95,114
2011-12-30 01:00:00,3,1,25.8,64.83,38.92,21,122,143
2011-12-30 02:00:00,3,2,11.13,77.07,21.94,3,188,191
2011-12-30 03:00:00,1,1,6.76,74.14,14.54,15,79,94
2011-12-30 04:00:00,1,2,21.38,21.32,15.24,20,35,55
2011-12-30 05:00:00,2,4,26.01,29.79,27.72,43,193,236
2011-12-30 06:00:00,1,4,34.95,33.01,15.11,20,80,100
2011-12-30 07:00:00,2,2,15.76,80.45,31.54,39,48,87
2011-12-30 08:00:00,4,2,31.89,55.21,49.47,40,2,42
2011-12-30 09:00:00,1,1,16.46,63.64,2.06,10,22,32
2011-12-30 10:00:00,3,4,25.68,81.81,8.44,36,186,222
2011-12-30 11:00:00,1,1,22.95,47.28,8.96,43,100,143
2011-12-30 12:00:00,2,2,6.59,79.91,22.35,21,155,176
2011-12-30 13:00:00,1,3,7.35,55.38,2.07,19,108,127
2011-12-30 14:00:00,4,3,5.62,50.17,23.88,1,104,105
2011-12-30 15:00:00,3,3,16.13,46.64,46.45,42,71,113
2011-12-30 16:00:00,2,2,27.37,97.2,0.58,10,32,42
2011-12-30 17:00:00,3,1,10.18,81.76,18.25,20,125,145
2011-12-30 18:00:00,3,4,23.18,21.62,38.04,32,67,99
2011-12-30 19:00:00,2,2,13.66,96.59,7.72,48,70,118
2011-12-30 20:00:00,3,3,28.91,82.04,3.88,16,10,26
2011-12-30 21:00:00,3,1,28.95,31.93,31.54,35,135,170
2011-12-30 22:00:00,1,4,28.26,26.11,0.5,13,19,32
2011-12-30 23:00:00,3,4,20.75,44.66,40.09,36,61,97
2011-12-31 00:00:00,3,2,13.54,69.93,3.34,30,170,200
2011-12-31 01:00:00,3,2,29.28,69.32,26.22,3,102,105
2011-12-31 02:00:00,3,4,10.58,42.07,37.01,5,91,96
2011-12-31 03:00:00,2,4,13.69,55.65,12.1,49,74,123
2011-12-31 04:00:00,4,3,10.52,36.95,5.18,20,113,133
2011-12-31 05:00:00,1,4,25.23,24.05,8.78,12,120,132
2011-12-31 06:00:00,3,2,25.59,61.36,42.73,37,197,234
2011-12-31 07:00:00,3,1,24.58,47.76,35.29,14,6,20
2011-12-31 08:00:00,2,3,17.47,63.43,9.9,4,137,141
2011-12-31 09:00:00,4,3,8.01,95.72,35.81,37,167,204
2011-12-31 10:00:00,3,4,32.34,31.47,35.43,23,3,26
2011-12-31 11:00:00,2,1,20.23,20.16,49.89,17,101,118
2011-12-31 12:00:00,1,3,17.21,26.15,19.58,28,18,46
2011-12-31 13:00:00,1,2,22.66,57.02,43.24,31,109,140
2011-12-31 14:00:00,3,4,10.78,76.55,22.32,6,165,171
2011-12-31 15:00:00,3,2,8.98,66.46,44.89,29,21,50
2011-12-31 16:00:00,4,4,17.17,59.59,4.58,37,102,139
2011-12-31 17:00:00,4,3,11.82,48.32,8.77,25,128,153
2011-12-31 18:00:00,3,4,12.33,44.8,42.5,7,112,119
2011-12-31 19:00:00,2,1,31.78,50.1,40.97,24,180,204
2011-12-31 20:00:00,4,2,20.92,68.93,15.27,29,148,177
2011-12-31 21:00:00,3,1,19.5,33.42,29.84,23,134,157
2011-12-31 22:00:00,4,2,25.68,81.71,19.13,29,6,35
2011-12-31 23:00:00,3,2,33.55,66.02,0.52,4,76,80
2012-01-01 00:00:00,1,4,8.37,41.53,1.31,3,22,25
2012-01-01 01:00:00,3,3,30.01,60.09,2.71,41,187,228
2012-01-01 02:00:00,1,3,22.52,97.02,29.7,8,89,97
2012-01-01 03:00:00,4,1,9.38,21.64,13.96,32,17,49
2012-01-01 04:00:00,3,4,13.91,35.96,7.2,28,116,144
2012-01-01 05:00:00,4,3,19.47,55.87,47.06,30,70,100
2012-01-01 06:00:00,1,2,25.74,71.08,6.07,43,65,108
2012-01-01 07:00:00,3,2,12.28,36.98,33.7,18,52,70
2012-01-01 08:00:00,4,4,21.05,94.51,44.71,44,146,190
2012-01-01 09:00:00,1,1,25.54,71.41,8.19,46,191,237
2012-01-01 10:00:00,4,4,18.46,90.19,10.74,1,141,142
2012-01-01 11:00:00,2,1,30.89,46.35,28.69,19,24,43
2012-01-01 12:00:00,1,4,31.08,86.32,25.42,11,32,43
2012-01-01 13:00:00,1,2,19.12,50.26,26.05,49,175,224
2012-01-01 14:00:00,1,4,34.19,40.22,27.73,20,38,58
2012-01-01 15:00:00,3,3,7.27,92.93,47.5,30,121,151
2012-01-01 16:00:00,3,3,5.1,27.38,2.69,35,111,146
2012-01-01 17:00:00,3,4,16.42,95.43,38.02,19,107,126
2012-01-01 18:00:00,2,1,23.03,56.68,11.63,43,132,175
2012-01-01 19:00:00,2,1,23.88,99.41,18.68,19,112,131
2012-01-01 20:00:00,1,2,19.29,63.17,4.46,44,148,192
2012-01-01 21:00:00,2,2,8.75,80.6,22.28,35,58,93
2012-01-01 22:00:00,4,1,10.11,20.57,40.21,45,119,164
2012-01-01 23:00:00,1,4,30.56,59.73,4.94,17,76,93
2012-01-02 00:00:00,1,2,31.04,79.0,13.78,5,13,18
2012-01-02 01:00:00,4,1,25.22,82.63,18.65,32,190,222
2012-01-02 02:00:00,1,1,24.93,32.64,5.19,9,53,62
2012-01-02 03:00:00,2,4,22.93,53.52,38.12,17,172,189
2012-01-02 04:00:00,3,3,11.09,53.53,39.35,33,177,210
2012-01-02 05:00:00,4,1,17.85,28.29,41.79,14,168,182
2012-01-02 06:00:00,2,2,25.88,55.44,29.19,2,91,93
2012-01-02 07:00:00,4,4,21.12,84.57,25.36,7,126,133
2012-01-02 08:00:00,4,4,5.56,44.01,13.13,10,128,138
2012-01-02 09:00:00,1,4,33.61,54.61,32.76,45,129,174
2012-01-02 10:00:00,1,3,30.34,96.88,22.23,31,71,102
2012-01-02 11:00:00,2,3,12.82,22.54,48.54,47,140,187
2012-01-02 12:00:00,4,2,23.49,67.32,48.41,41,146,187
2012-01-02 13:00:00,1,2,32.7,79.47,45.26,16,50,66
2012-01-02 14:00:00,1,4,7.88,80.87,18.0,46,125,171
2012-01-02 15:00:00,4,2,20.09,77.28,18.4,29,1,30
2012-01-02 16:00:00,2,1,18.69,78.12,42.63,42,9,51
2012-01-02 17:00:00,2,3,17.31,24.72,36.46,7,196,203
2012-01-02 18:00:00,4,4,30.07,62.73,35.22,39,117,156
2012-01-02 19:00:00,2,4,16.42,82.64,13.98,6,29,35
2012-01-02 20:00:00,1,1,6.91,27.53,41.67,19,64,83
2012-01-02 21:00:00,4,1,6.98,20.96,28.97,11,108,119
2012-01-02 22:00:00,1,1,6.28,85.16,22.34,20,43,63
2012-01-02 23:00:00,3,1,17.27,76.98,43.27,27,41,68
2012-01-03 00:00:00,3,4,26.55,52.98,19.71,27,2,29
2012-01-03 01:00:00,2,3,11.11,95.23,32.7,15,110,125
2012-01-03 02:00:00,3,3,24.39,81.33,23.3,47,157,204
2012-01-03 03:00:00,1,1,25.61,97.43,29.64,9,164,173
2012-01-03 04:00:00,3,2,12.66,94.35,2.03,21,27,48
2012-01-03 05:00:00,1,4,23.02,58.5,23.06,6,50,56
2012-01-03 06:00:00,2,3,25.55,80.38,27.82,3,114,117
2012-01-03 07:00:00,2,1,19.0,73.54,24.64,23,124,147
2012-01-03 08:00:00,1,2,15.1,84.92,42.37,33,12,45
2012-01-03 09:00:00,3,2,23.57,83.02,15.56,40,39,79
2012-01-03 10:00:00,2,1,34.34,32.26,44.2,46,153,199
2012-01-03 11:00:00,4,4,17.81,38.7,20.17,13,103,116
2012-01-03 12:00:00,2,3,16.75,41.26,34.73,43,157,200
2012-01-03 13:00:00,3,2,18.93,85.48,4.34,48,151,199
2012-01-03 14:00:00,4,3,7.29,84.86,10.01,16,37,53
2012-01-03 15:00:00,3,3,21.59,59.63,38.06,44,104,148
2012-01-03 16:00:00,1,2,14.86,66.47,0.62,7,109,116
2012-01-03 17:00:00,4,1,8.64,86.15,48.43,41,196,237
2012-01-03 18:00:00,3,2,18.99,45.01,9.53,12,15,27
2012-01-03 19:00:00,4,2,5.1,24.01,45.07,6,109,115
2012-01-03 20:00:00,3,4,17.05,58.61,25.8,2,54,56
2012-01-03 21:00:00,4,3,8.17,93.1,28.23,23,176,199
2012-01-03 22:00:00,3,1,5.73,83.24,4.21,46,126,172
2012-01-03 23:00:00,1,3,29.73,49.33,18.26,23,79,102
2012-01-04 00:00:00,4,2,32.49,25.18,7.81,6,51,57
2012-01-04 01:00:00,4,1,11.23,70.95,26.3,29,48,77
2012-01-04 02:00:00,4,1,21.18,86.76,27.54,4,191,195
2012-01-04 03:00:00,4,1,13.34,73.2,35.48,39,47,86
2012-01-04 04:00:00,1,1,19.81,54.01,43.91,20,73,93
2012-01-04 05:00:00,4,4,18.1,29.87,23.41,48,81,129
2012-01-04 06:00:00,2,1,13.07,92.86,11.67,7,37,44
2012-01-04 07:00:00,1,2,26.01,42.08,16.68,6,16,22
2012-01-04 08:00:00,2,4,8.79,37.94,42.35,38,40,78
2012-01-04 09:00:00,4,2,6.59,85.28,7.29,1,53,54
2012-01-04 10:00:00,3,2,28.03,98.5,31.36,42,39,81
2012-01-04 11:00:00,2,3,24.98,72.81,0.65,11,30,41
2012-01-04 12:00:00,4,1,19.96,69.98,12.28,27,89,116
2012-01-04 13:00:00,2,1,19.03,45.55,29.57,43,153,196
2012-01-04 14:00:00,4,2,19.92,21.63,22.82,18,75,93
2012-01-04 15:00:00,4,1,18.11,35.34,24.68,27,145,172
2012-01-04 16:00:00,4,4,16.79,66.75,33.03,34,34,68
2012-01-04 17:00:00,3,3,19.99,32.11,11.73,11,122,133
2012-01-04 18:00:00,2,1,20.86,90.71,14.04,27,119,146
2012-01-04 19:00:00,1,1,25.76,35.05,34.22,25,55,80
2012-01-04 20:00:00,1,4,26.34,61.77,26.91,37,116,153
2012-01-04 21:00:00,1,3,16.33,60.96,0.73,5,29,34
2012-01-04 22:00:00,1,4,17.41,68.32,33.52,18,172,190
2012-01-04 23:00:00,4,2,16.21,46.19,31.0,26,74,100
2012-01-05 00:00:00,2,2,21.1,89.88,3.93,8,51,59
2012-01-05 01:00:00,2,1,18.6,55.54,37.38,40,195,235
2012-01-05 02:00:00,3,3,31.69,76.01,26.11,49,54,103
2012-01-05 03:00:00,2,2,25.89,70.87,10.24,9,137,146
2012-01-05 04:00:00,2,4,31.96,29.37,27.97,9,181,190
2012-01-05 05:00:00,2,2,26.27,69.81,29.77,32,33,65
2012-01-05 06:00:00,3,2,34.13,64.06,46.01,17,190,207
2012-01-05 07:00:00,1,4,24.07,91.89,37.11,9,158,167
2012-01-05 08:00:00,2,1,33.91,90.47,15.1,6,191,197
2012-01-05 09:00:00,3,3,9.75,32.08,5.91,39,177,216
2012-01-05 10:00:00,3,1,6.57,26.53,42.66,31,155,186
2012-01-05 11:00:00,4,4,22.37,43.57,42.3,42,106,148
2012-01-05 12:00:00,3,2,34.5,98.93,8.77,5,36,41
2012-01-05 13:00:00,1,3,17.53,21.73,3.11,18,159,177
2012-01-05 14:00:00,2,1,11.36,73.83,35.59,40,34,74
2012-01-05 15:00:00,3,4,20.65,68.68,36.13,42,184,226
2012-01-05 16:00:00,1,2,24.46,71.73,8.86,33,188,221
2012-01-05 17:00:00,3,2,14.46,37.46,33.41,42,84,126
2012-01-05 18:00:00,3,1,26.44,38.14,13.95,4,31,35
2012-01-05 19:00:00,3,4,34.25,54.45,13.03,18,7,25
2012-01-05 20:00:00,3,2,31.91,27.67,16.23,48,162,210
2012-01-05 21:00:00,3,2,13.75,25.97,26.02,49,22,71
2012-01-05 22:00:00,1,3,14.8,27.07,40.22,13,92,105
2012-01-05 23:00:00,2,2,16.15,65.84,24.93,9,165,174
2012-01-06 00:00:00,2,1,16.84,51.82,14.9,48,18,66
2012-01-06 01:00:00,2,4,8.01,43.49,44.2,10,181,191
2012-01-06 02:00:00,2,4,27.86,45.27,2.75,30,44,74
2012-01-06 03:00:00,1,3,15.96,36.58,39.85,1,35,36
2012-01-06 04:00:00,4,4,31.39,52.92,39.22,9,176,185
2012-01-06 05:00:00,4,1,32.81,36.24,12.68,20,187,207
2012-01-06 06:00:00,1,2,5.73,75.84,9.91,0,55,55
2012-01-06 07:00:00,1,3,34.66,29.91,43.74,45,63,108
2012-01-06 08:00:00,3,4,26.3,95.86,27.94,30,61,91
2012-01-06 09:00:00,3,3,20.61,27.19,2.3,10,58,68
2012-01-06 10:00:00,3,3,16.69,95.48,44.54,42,0,42
2012-01-06 11:00:00,2,4,20.56,86.66,17.45,9,96,105
2012-01-06 12:00:00,3,3,14.74,74.46,17.11,19,76,95
2012-01-06 13:00:00,4,4,23.68,92.98,32.16,20,4,24
2012-01-06 14:00:00,2,1,7.79,31.14,33.07,36,146,182
2012-01-06 15:00:00,3,4,23.63,34.11,17.67,36,57,93
2012-01-06 16:00:00,2,2,13.26,40.17,7.16,13,56,69
2012-01-06 17:00:00,4,4,5.53,39.58,27.61,4,169,173
2012-01-06 18:00:00,3,2,21.58,44.87,31.26,5,72,77
2012-01-06 19:00:00,4,3,22.35,66.05,43.01,23,133,156
2012-01-06 20:00:00,4,4,17.8,22.25,24.22,15,84,99
2012-01-06 21:00:00,4,2,7.17,50.58,32.28,22,21,43
2012-01-06 22:00:00,3,4,31.8,39.71,2.72,46,52,98
2012-01-06 23:00:00,1,4,23.34,68.53,44.73,37,56,93
2012-01-07 00:00:00,3,4,8.47,98.81,16.36,15,125,140
2012-01-07 01:00:00,4,1,20.33,61.41,31.61,12,102,114
2012-01-07 02:00:00,3,2,19.92,54.05,45.8,44,111,155
2012-01-07 03:00:00,4,1,6.81,49.46,40.53,7,50,57
2012-01-07 04:00:00,1,1,23.21,82.8,31.89,37,4,41
2012-01-07 05:00:00,2,2,29.25,25.76,35.18,31,149,180
2012-01-07 06:00:00,1,4,27.47,96.78,46.05,21,113,134
2012-01-07 07:00:00,1,1,11.09,53.43,40.6,16,134,150
2012-01-07 08:00:00,2,1,30.87,45.1,30.49,4,63,67
2012-01-07 09:00:00,3,1,15.28,97.93,32.94,7,184,191
2012-01-07 10:00:00,2,4,33.4,94.87,7.36,49,25,74
2012-01-07 11:00:00,3,1,7.15,71.35,23.51,29,24,53
2012-01-07 12:00:00,3,3,19.59,21.48,15.05,18,68,86
2012-01-07 13:00:00,4,2,22.91,79.88,21.6,11,159,170
2012-01-07 14:00:00,4,3,12.43,46.84,33.11,24,7,31
2012-01-07 15:00:00,2,4,28.14,51.06,7.46,43,8,51
2012-01-07 16:00:00,1,1,23.81,32.7,0.87,12,53,65
2012-01-07 17:00:00,2,2,5.54,61.88,19.85,3,19,22
2012-01-07 18:00:00,3,1,23.25,79.56,16.11,9,195,204
2012-01-07 19:00:00,4,4,19.74,41.84,21.02,47,194,241
2012-01-07 20:00:00,2,2,10.88,95.1,46.56,27,171,198
2012-01-07 21:00:00,2,3,34.87,35.58,35.35,4,168,172
2012-01-07 22:00:00,4,2,31.91,25.3,16.37,27,169,196
2012-01-07 23:00:00,4,1,13.78,71.55,8.96,43,138,181
2012-01-08 00:00:00,4,2,21.23,87.95,30.92,30,111,141
2012-01-08 01:00:00,3,4,14.5,96.25,32.88,15,126,141
2012-01-08 02:00:00,4,4,28.26,81.37,24.18,22,170,192
2012-01-08 03:00:00,1,2,32.91,35.97,10.64,28,135,163
2012-01-08 04:00:00,2,4,15.76,98.21,1.43,46,173,219
2012-01-08 05:00:00,4,4,29.17,93.55,13.28,20,33,53
2012-01-08 06:00:00,4,4,19.95,33.05,22.86,1,67,68
2012-01-08 07:00:00,3,3,16.9,64.7,39.4,22,142,164
2012-01-08 08:00:00,3,1,33.15,64.44,42.69,15,145,160
2012-01-08 09:00:00,2,4,20.31,55.4,20.65,10,138,148
2012-01-08 10:00:00,1,2,19.02,98.74,39.81,8,146,154
2012-01-08 11:00:00,2,4,25.17,24.77,49.67,1,72,73
2012-01-08 12:00:00,4,3,12.84,70.18,35.83,17,24,41
2012-01-08 13:00:00,1,2,14.74,36.42,36.43,12,149,161
2012-01-08 14:00:00,1,1,32.96,62.19,45.48,44,189,233
2012-01-08 15:00:00,1,2,25.36,82.38,16.91,7,164,171
2012-01-08 16:00:00,1,2,29.8,39.74,0.56,9,137,146
2012-01-08 17:00:00,2,2,13.13,51.47,49.35,26,80,106
2012-01-08 18:00:00,3,2,21.31,96.06,24.52,16,51,67
2012-01-08 19:00:00,3,4,34.14,80.92,39.28,23,76,99
2012-01-08 20:00:00,4,1,14.56,65.82,40.62,20,67,87
2012-01-08 21:00:00,3,4,9.81,37.76,19.88,0,27,27
2012-01-08 22:00:00,3,3,20.33,54.02,27.06,15,157,172
2012-01-08 23:00:00,3,3,16.63,81.92,27.0,42,173,215
2012-01-09 00:00:00,3,2,9.79,85.64,11.01,32,167,199
2012-01-09 01:00:00,4,4,31.66,39.57,5.88,5,148,153
2012-01-09 02:00:00,2,4,34.72,72.96,27.18,11,142,153
2012-01-09 03:00:00,1,1,22.06,27.6,6.01,31,130,161
2012-01-09 04:00:00,3,1,28.24,21.86,17.3,47,80,127
2012-01-09 05:00:00,2,1,30.77,63.89,9.3,10,96,106
2012-01-09 06:00:00,3,4,26.03,37.95,35.35,17,196,213
2012-01-09 07:00:00,3,1,6.32,26.31,43.6,1,7,8
2012-01-09 08:00:00,1,1,9.73,78.39,28.9,31,136,167
2012-01-09 09:00:00,1,1,7.13,59.84,20.51,48,121,169
2012-01-09 10:00:00,1,2,5.3,83.7,49.83,48,89,137
2012-01-09 11:00:00,3,3,14.18,73.12,1.06,19,129,148
2012-01-09 12:00:00,3,3,16.77,78.38,15.22,20,164,184
2012-01-09 13:00:00,3,4,12.23,44.59,13.93,35,139,174
2012-01-09 14:00:00,1,4,6.94,41.06,17.81,37,18,55
2012-01-09 15:00:00,4,2,20.9,68.07,11.53,26,26,52
2012-01-09 16:00:00,2,3,13.2,36.01,13.21,46,151,197
2012-01-09 17:00:00,4,1,28.88,85.23,12.88,10,193,203
2012-01-09 18:00:00,3,1,5.24,61.83,25.29,17,15,32
2012-01-09 19:00:00,3,4,30.28,38.16,19.55,16,1,17
2012-01-09 20:00:00,4,3,33.64,70.01,31.96,33,148,181
2012-01-09 21:00:00,3,4,26.48,95.6,25.72,44,9,53
2012-01-09 22:00:00,2,4,27.01,26.57,9.17,25,185,210
2012-01-09 23:00:00,3,1,33.01,28.75,40.5,5,105,110
2012-01-10 00:00:00,2,1,11.27,87.51,23.61,42,16,58
2012-01-10 01:00:00,4,3,34.84,28.77,7.66,29,6,35
2012-01-10 02:00:00,4,4,28.2,23.15,8.34,38,45,83
2012-01-10 03:00:00,3,2,26.8,47.83,39.85,49,177,226
2012-01-10 04:00:00,2,3,15.83,57.34,35.15,31,9,40
2012-01-10 05:00:00,3,4,21.37,65.56,25.33,16,15,31
2012-01-10 06:00:00,1,3,24.62,60.58,15.3,12,0,12
2012-01-10 07:00:00,1,3,23.61,93.05,23.03,45,136,181
2012-01-10 08:00:00,1,3,26.15,81.49,31.82,40,12,52
2012-01-10 09:00:00,1,2,7.47,98.7,43.96,12,188,200
2012-01-10 10:00:00,3,2,15.67,58.12,27.79,5,175,180
2012-01-10 11:00:00,1,1,18.02,26.75,13.84,21,143,164
2012-01-10 12:00:00,2,1,12.82,96.44,2.14,32,168,200
2012-01-10 13:00:00,4,4,10.18,20.33,8.77,32,29,61
2012-01-10 14:00:00,4,3,9.17,82.09,32.51,3,71,74
2012-01-10 15:00:00,1,4,15.99,22.5,8.02,13,182,195
2012-01-10 16:00:00,1,1,19.8,80.9,24.08,49,10,59
2012-01-10 17:00:00,1,2,6.89,95.04,34.95,47,112,159
2012-01-10 18:00:00,3,1,33.39,51.14,15.41,34,179,213
2012-01-10 19:00:00,4,4,27.96,39.28,33.46,26,74,100
2012-01-10 20:00:00,1,1,26.93,38.1,29.05,5,47,52
2012-01-10 21:00:00,2,4,10.19,59.34,21.95,0,6,6
2012-01-10 22:00:00,1,4,23.11,33.67,44.86,42,181,223
2012-01-10 23:00:00,4,4,20.89,73.83,34.6,27,0,27
2012-01-11 00:00:00,1,4,34.47,49.47,18.03,28,86,114
2012-01-11 01:00:00,4,1,27.43,45.85,40.21,31,31,62
2012-01-11 02:00:00,1,4,22.27,56.9,36.91,27,61,88
2012-01-11 03:00:00,2,4,30.52,63.41,39.58,26,142,168
2012-01-11 04:00:00,1,3,9.65,31.35,32.05,9,91,100
2012-01-11 05:00:00,2,4,5.46,76.62,18.97,17,188,205
2012-01-11 06:00:00,2,1,25.71,90.64,17.43,3,77,80
2012-01-11 07:00:00,1,4,7.95,42.24,32.71,37,76,113
2012-01-11 08:00:00,2,2,8.46,34.43,6.55,40,183,223
2012-01-11 09:00:00,3,2,27.34,80.84,41.0,41,33,74
2012-01-11 10:00:00,1,4,13.12,34.68,18.52,31,147,178
2012-01-11 11:00:00,1,2,23.86,23.3,31.52,4,117,121
2012-01-11 12:00:00,2,2,32.52,69.54,24.95,21,23,44
2012-01-11 13:00:00,2,1,14.49,39.18,25.97,47,27,74
2012-01-11 14:00:00,1,3,11.51,33.74,36.9,21,10,31
2012-01-11 15:00:00,3,2,8.2,98.53,31.33,1,157,158
2012-01-11 16:00:00,2,2,8.91,43.35,12.52,40,37,77
2012-01-11 17:00:00,2,3,6.87,92.28,3.71,42,128,170
2012-01-11 18:00:00,4,3,7.63,34.26,42.01,33,120,153
2012-01-11 19:00:00,3,2,17.96,85.52,44.24,49,196,245
2012-01-11 20:00:00,3,4,14.63,60.16,8.22,1,160,161
2012-01-11 21:00:00,1,2,26.2,26.29,15.47,45,108,153
2012-01-11 22:00:00,3,4,31.11,78.69,14.12,35,64,99
2012-01-11 23:00:00,1,4,28.54,91.37,46.87,39,171,210
2012-01-12 00:00:00,4,4,20.92,33.04,10.24,7,63,70
2012-01-12 01:00:00,3,3,8.07,78.05,8.33,32,8,40
2012-01-12 02:00:00,2,2,26.29,55.6,9.09,32,31,63
2012-01-12 03:00:00,4,2,15.88,80.31,36.49,3,53,56
2012-01-12 04:00:00,1,1,7.57,77.11,44.4,17,124,141
2012-01-12 05:00:00,4,3,30.27,22.13,19.67,18,25,43
2012-01-12 06:00:00,1,1,15.15,34.3,6.8,9,61,70
2012-01-12 07:00:00,4,1,11.55,57.68,29.29,49,108,157
2012-01-12 08:00:00,1,4,31.14,94.69,10.5,41,169,210
2012-01-12 09:00:00,3,3,32.06,47.37,3.21,40,175,215
2012-01-12 10:00:00,2,1,15.17,70.31,44.31,29,133,162
2012-01-12 11:00:00,1,2,15.64,20.97,43.54,21,117,138
2012-01-12 12:00:00,4,1,22.39,76.89,48.8,38,29,67
2012-01-12 13:00:00,1,3,27.0,68.25,23.7,37,150,187
2012-01-12 14:00:00,1,2,6.89,77.23,14.7,0,102,102
2012-01-12 15:00:00,1,2,22.8,92.37,38.49,29,24,53
2012-01-12 16:00:00,4,2,33.58,31.72,9.02,4,140,144
2012-01-12 17:00:00,2,4,12.86,40.93,12.16,46,152,198
2012-01-12 18:00:00,3,2,32.26,99.66,12.78,25,16,41
2012-01-12 19:00:00,2,4,33.51,32.5,47.58,45,107,152
2012-01-12 20:00:00,1,4,13.07,77.65,36.49,30,26,56
2012-01-12 21:00:00,4,1,27.63,78.01,6.68,38,138,176
2012-01-12 22:00:00,2,1,12.16,74.64,4.64,40,133,173
2012-01-12 23:00:00,1,2,27.13,38.2,42.14,11,78,89
2012-01-13 00:00:00,3,3,28.92,37.21,40.11,16,36,52
2012-01-13 01:00:00,3,2,12.42,73.31,33.55,17,111,128
2012-01-13 02:00:00,3,1,26.48,34.9,9.81,1,105,106
2012-01-13 03:00:00,1,2,29.36,72.93,24.01,48,199,247
2012-01-13 04:00:00,4,1,15.76,59.4,30.14,23,119,142
2012-01-13 05:00:00,2,2,10.03,50.93,46.61,27,164,191
2012-01-13 06:00:00,3,3,7.76,44.02,8.47,38,58,96
2012-01-13 07:00:00,1,2,22.26,95.81,25.77,9,9,18
2012-01-13 08:00:00,1,3,34.34,60.65,7.89,46,0,46
2012-01-13 09:00:00,2,3,29.69,64.9,22.19,32,51,83
2012-01-13 10:00:00,3,2,18.08,95.94,10.01,23,145,168
2012-01-13 11:00:00,1,3,21.1,72.31,41.81,10,86,96
2012-01-13 12:00:00,2,3,13.39,96.63,12.74,7,4,11
2012-01-13 13:00:00,4,1,9.89,28.51,20.86,26,127,153
2012-01-13 14:00:00,4,1,19.46,87.73,20.39,25,101,126
2012-01-13 15:00:00,4,3,18.91,46.83,43.31,11,117,128
2012-01-13 16:00:00,3,4,20.66,84.84,37.89,34,116,150
2012-01-13 17:00:00,2,2,33.58,88.45,2.88,14,102,116
2012-01-13 18:00:00,2,3,23.12,41.72,3.35,20,92,112
2012-01-13 19:00:00,1,2,23.17,52.71,27.56,36,47,83
2012-01-13 20:00:00,1,1,8.84,78.08,21.39,29,32,61
2012-01-13 21:00:00,1,2,34.89,27.92,13.78,4,184,188
2012-01-13 22:00:00,2,3,28.19,80.44,39.63,16,102,118
2012-01-13 23:00:00,1,3,31.32,28.84,6.43,25,24,49
2012-01-14 00:00:00,2,3,17.43,93.16,48.7,33,43,76
2012-01-14 01:00:00,2,3,20.06,42.11,1.21,32,90,122
2012-01-14 02:00:00,4,4,20.66,66.05,5.91,17,120,137
2012-01-14 03:00:00,1,4,10.82,29.37,15.57,24,110,134
2012-01-14 04:00:00,4,4,25.68,41.56,25.46,40,65,105
2012-01-14 05:00:00,3,3,32.09,52.32,10.81,29,127,156
2012-01-14 06:00:00,3,4,9.91,58.96,36.81,36,195,231
2012-01-14 07:00:00,3,2,7.59,20.01,17.88,19,152,171
2012-01-14 08:00:00,2,3,27.15,91.09,1.93,44,172,216
2012-01-14 09:00:00,2,1,13.2,20.61,43.89,1,22,23
2012-01-14 10:00:00,2,3,23.72,81.89,47.19,12,99,111
2012-01-14 11:00:00,1,2,25.87,57.65,30.93,39,168,207
2012-01-14 12:00:00,4,4,14.66,61.91,40.33,41,86,127
2012-01-14 13:00:00,2,3,29.45,36.66,6.06,19,119,138
2012-01-14 14:00:00,4,4,21.5,68.59,13.44,5,160,165
2012-01-14 15:00:00,4,3,31.07,62.98,16.26,10,120,130
2012-01-14 16:00:00,4,2,27.9,33.14,48.04,45,27,72
2012-01-14 17:00:00,1,3,31.06,39.05,25.61,24,7,31
2012-01-14 18:00:00,1,4,5.6,25.35,0.37,41,156,197
2012-01-14 19:00:00,3,4,12.31,25.3,19.01,9,111,120
2012-01-14 20:00:00,3,2,7.7,21.1,0.39,30,183,213
2012-01-14 21:00:00,4,3,18.26,37.64,11.89,42,142,184
2012-01-14 22:00:00,3,1,31.7,74.37,22.74,3,14,17
2012-01-14 23:00:00,4,3,19.03,45.3,16.17,24,36,60
2012-01-15 00:00:00,1,2,30.49,47.42,1.64,27,146,173
2012-01-15 01:00:00,1,1,14.82,30.55,5.82,23,106,129
2012-01-15 02:00:00,1,2,15.19,66.04,27.54,34,186,220
2012-01-15 03:00:00,2,3,31.87,47.37,34.78,40,178,218
2012-01-15 04:00:00,4,1,17.77,74.11,20.23,4,119,123
2012-01-15 05:00:00,1,2,28.69,79.32,36.57,32,84,116
2012-01-15 06:00:00,4,4,12.1,66.78,8.17,10,162,172
2012-01-15 07:00:00,3,1,33.46,42.09,6.1,7,117,124
2012-01-15 08:00:00,3,1,22.24,60.69,41.97,20,91,111
2012-01-15 09:00:00,1,2,27.78,40.15,16.96,31,35,66
2012-01-15 10:00:00,4,4,7.69,92.23,21.61,4,180,184
2012-01-15 11:00:00,1,1,19.78,81.31,47.38,33,79,112
2012-01-15 12:00:00,3,2,32.03,59.44,21.21,8,11,19
2012-01-15 13:00:00,1,1,31.31,97.24,0.17,37,27,64
2012-01-15 14:00:00,4,1,6.4,63.74,46.9,42,198,240
2012-01-15 15:00:00,3,1,14.11,46.28,0.71,31,32,63
2012-01-15 16:00:00,2,4,18.3,27.64,33.11,9,74,83
2012-01-15 17:00:00,3,3,10.17,63.5,16.14,11,78,89
2012-01-15 18:00:00,2,3,26.9,88.83,23.52,34,182,216
2012-01-15 19:00:00,1,4,10.54,89.34,27.36,38,78,116
2012-01-15 20:00:00,1,4,15.4,68.37,20.42,17,49,66
2012-01-15 21:00:00,4,2,24.9,51.48,38.72,22,28,50
2012-01-15 22:00:00,2,1,19.46,72.02,46.54,11,57,68
2012-01-15 23:00:00,1,4,27.16,80.97,4.32,30,25,55
2012-01-16 00:00:00,2,2,33.84,52.93,40.01,10,22,32
2012-01-16 01:00:00,1,3,8.5,58.1,6.43,33,16,49
2012-01-16 02:00:00,3,3,26.29,74.45,4.01,26,132,158
2012-01-16 03:00:00,1,3,11.91,90.13,47.79,20,58,78
2012-01-16 04:00:00,4,3,17.43,83.28,24.46,9,143,152
2012-01-16 05:00:00,3,2,5.99,21.79,7.63,12,102,114
2012-01-16 06:00:00,4,1,9.08,29.95,28.5,44,93,137
2012-01-16 07:00:00,3,2,14.59,88.22,13.16,46,148,194
2012-01-16 08:00:00,2,1,15.26,86.71,23.22,24,4,28
2012-01-16 09:00:00,4,3,31.99,51.1,31.23,12,185,197
2012-01-16 10:00:00,1,4,27.25,66.74,43.46,40,25,65
2012-01-16 11:00:00,2,4,34.17,92.47,0.15,5,170,175
2012-01-16 12:00:00,1,4,22.97,92.92,10.71,34,111,145
2012-01-16 13:00:00,3,1,12.25,82.65,4.81,27,125,152
2012-01-16 14:00:00,3,3,14.83,36.77,4.85,19,186,205
2012-01-16 15:00:00,1,2,14.6,78.42,47.29,19,85,104
2012-01-16 16:00:00,1,4,14.79,28.09,46.8,40,185,225
2012-01-16 17:00:00,2,1,25.19,91.52,37.47,3,108,111
2012-01-16 18:00:00,1,4,20.92,31.93,32.15,19,1,20
2012-01-16 19:00:00,4,2,16.56,72.99,42.4,4,43,47
2012-01-16 20:00:00,4,3,9.47,68.82,2.92,21,105,126
2012-01-16 21:00:00,1,2,5.66,82.15,5.97,23,153,176
2012-01-16 22:00:00,4,3,11.57,64.13,15.86,43,108,151
2012-01-16 23:00:00,1,3,8.22,24.77,41.62,16,43,59
2012-01-17 00:00:00,2,3,28.56,76.47,23.61,4,146,150
2012-01-17 01:00:00,4,4,8.37,50.65,25.18,25,48,73
2012-01-17 02:00:00,4,2,26.73,45.62,11.46,35,90,125
2012-01-17 03:00:00,1,4,16.57,99.33,32.42,7,80,87
2012-01-17 04:00:00,4,2,7.2,67.23,44.39,8,184,192
2012-01-17 05:00:00,3,1,29.38,76.86,16.48,16,133,149
2012-01-17 06:00:00,2,1,22.39,62.11,30.96,7,150,157
2012-01-17 07:00:00,2,2,12.07,81.6,16.6,4,81,85
2012-01-17 08:00:00,4,2,31.84,80.17,39.64,9,42,51
2012-01-17 09:00:00,4,2,6.36,72.57,23.75,49,43,92
2012-01-17 10:00:00,3,2,11.05,99.82,16.97,13,65,78
2012-01-17 11:00:00,3,3,27.56,56.78,21.0,26,44,70
2012-01-17 12:00:00,4,4,26.28,76.5,4.56,26,18,44
2012-01-17 13:00:00,4,3,13.68,83.82,43.31,4,3,7
2012-01-17 14:00:00,3,4,6.86,50.08,47.9,14,96,110
2012-01-17 15:00:00,1,4,30.74,56.57,23.87,27,97,124
2012-01-17 16:00:00,3,4,14.41,97.53,11.07,4,95,99
2012-01-17 17:00:00,1,3,10.87,22.58,33.23,21,184,205
2012-01-17 18:00:00,2,2,20.48,46.82,22.62,11,136,147
2012-01-17 19:00:00,2,3,32.31,58.9,12.62,41,100,141
2012-01-17 20:00:00,3,3,6.31,20.12,1.92,7,47,54
2012-01-17 21:00:00,1,4,27.97,91.93,44.49,0,163,163
2012-01-17 22:00:00,3,1,22.17,42.9,39.84,34,194,228
2012-01-17 23:00:00,3,1,17.76,40.62,41.45,15,17,32
2012-01-18 00:00:00,1,3,27.32,85.63,21.99,29,39,68
2012-01-18 01:00:00,3,4,33.97,42.24,37.66,42,193,235
2012-01-18 02:00:00,2,3,11.88,72.61,29.06,40,64,104
2012-01-18 03:00:00,4,3,9.31,85.72,18.74,9,151,160
2012-01-18 04:00:00,4,2,32.39,83.4,42.14,33,180,213
2012-01-18 05:00:00,3,4,25.07,82.56,49.94,10,113,123
2012-01-18 06:00:00,1,1,18.14,27.09,44.96,19,169,188
2012-01-18 07:00:00,1,1,22.2,26.39,38.81,42,52,94
2012-01-18 08:00:00,2,1,27.37,44.54,37.38,6,61,67
2012-01-18 09:00:00,1,3,28.19,22.88,32.51,20,189,209
2012-01-18 10:00:00,1,4,32.6,60.03,42.68,10,195,205
2012-01-18 11:00:00,2,2,17.81,51.58,24.65,36,125,161
2012-01-18 12:00:00,3,1,13.8,64.56,9.09,22,113,135
2012-01-18 13:00:00,4,4,24.19,43.9,38.4,43,162,205
2012-01-18 14:00:00,2,1,17.47,58.86,45.98,30,184,214
2012-01-18 15:00:00,3,2,22.84,46.78,17.07,17,60,77
2012-01-18 16:00:00,2,4,17.6,35.62,39.15,23,139,162
2012-01-18 17:00:00,3,3,9.59,71.95,13.69,21,48,69
2012-01-18 18:00:00,2,3,19.08,73.87,47.13,36,149,185
2012-01-18 19:00:00,3,1,25.73,86.34,34.17,46,89,135
2012-01-18 20:00:00,2,1,28.98,89.98,28.46,43,67,110
2012-01-18 21:00:00,3,4,19.8,76.36,38.99,0,70,70
2012-01-18 22:00:00,2,2,9.96,75.0,40.66,49,150,199
2012-01-18 23:00:00,4,1,17.44,24.53,44.62,5,94,99
2012-01-19 00:00:00,4,4,28.59,28.78,45.06,37,134,171
2012-01-19 01:00:00,1,2,17.39,85.01,2.63,28,125,153
2012-01-19 02:00:00,3,1,25.9,38.64,6.15,42,21,63
2012-01-19 03:00:00,2,1,20.22,48.45,41.3,10,102,112
2012-01-19 04:00:00,3,4,12.24,31.62,47.3,15,39,54
2012-01-19 05:00:00,4,1,28.88,35.61,15.38,5,146,151
2012-01-19 06:00:00,3,3,7.53,82.03,0.43,0,52,52
2012-01-19 07:00:00,2,2,20.75,40.95,16.14,47,29,76
2012-01-19 08:00:00,3,2,11.27,55.92,19.14,34,153,187
2012-01-19 09:00:00,2,3,7.01,32.13,38.05,23,122,145
2012-01-19 10:00:00,4,4,20.09,74.23,2.38,37,168,205
2012-01-19 11:00:00,4,3,19.99,78.26,10.63,2,119,121
2012-01-19 12:00:00,4,3,26.21,48.94,44.7,39,149,188
2012-01-19 13:00:00,1,2,27.34,82.78,7.74,1,60,61
2012-01-19 14:00:00,4,4,26.83,39.19,37.96,14,72,86
2012-01-19 15:00:00,3,1,17.29,75.35,18.07,21,45,66
2012-01-19 16:00:00,1,3,23.95,78.4,33.13,45,57,102
2012-01-19 17:00:00,4,3,22.31,97.49,3.69,45,28,73
2012-01-19 18:00:00,3,4,17.65,38.59,14.33,3,52,55
2012-01-19 19:00:00,3,3,22.92,27.5,21.24,23,145,168
2012-01-19 20:00:00,3,4,33.42,41.04,42.86,18,158,176
2012-01-19 21:00:00,2,1,10.79,29.83,28.17,29,31,60
2012-01-19 22:00:00,1,4,32.17,33.58,2.26,21,8,29
2012-01-19 23:00:00,3,1,6.6,46.73,40.09,38,36,74
2012-01-20 00:00:00,2,4,14.25,53.12,2.73,47,7,54
2012-01-20 01:00:00,4,3,13.64,92.3,46.72,39,151,190
2012-01-20 02:00:00,3,1,23.79,35.65,10.59,26,67,93
2012-01-20 03:00:00,2,3,8.94,97.74,24.4,14,51,65
2012-01-20 04:00:00,3,1,31.47,84.81,3.61,36,45,81
2012-01-20 05:00:00,1,4,29.86,90.52,28.09,0,16,16
2012-01-20 06:00:00,1,4,24.56,94.36,24.86,11,20,31
2012-01-20 07:00:00,4,4,18.75,80.26,20.51,8,47,55
2012-01-20 08:00:00,3,2,32.99,83.1,1.78,18,8,26
2012-01-20 09:00:00,2,2,29.92,55.03,43.95,17,196,213
2012-01-20 10:00:00,4,1,19.98,60.84,40.13,38,4,42
2012-01-20 11:00:00,3,2,26.06,94.6,31.65,10,5,15
2012-01-20 12:00:00,4,4,22.01,50.26,28.61,10,199,209
2012-01-20 13:00:00,2,2,22.64,23.36,34.75,29,175,204
2012-01-20 14:00:00,4,2,14.93,81.02,7.2,19,45,64
2012-01-20 15:00:00,4,3,18.86,65.85,46.63,14,96,110
2012-01-20 16:00:00,4,1,7.34,85.19,14.23,24,111,135
2012-01-20 17:00:00,3,1,15.72,26.04,32.82,48,100,148
2012-01-20 18:00:00,2,1,25.87,69.7,30.34,2,190,192
2012-01-20 19:00:00,1,2,33.6,39.82,31.83,42,130,172
2012-01-20 20:00:00,3,4,33.89,92.26,43.95,25,158,183
2012-01-20 21:00:00,1,3,21.67,28.79,14.8,44,122,166
2012-01-20 22:00:00,1,1,23.2,87.45,37.45,27,102,129
2012-01-20 23:00:00,3,2,10.57,27.08,29.92,5,134,139
2012-01-21 00:00:00,3,4,25.86,22.01,3.8,45,15,60
2012-01-21 01:00:00,2,3,7.12,38.8,20.71,31,91,122
2012-01-21 02:00:00,2,3,13.54,46.64,41.9,10,121,131
2012-01-21 03:00:00,4,1,25.05,70.12,15.77,12,142,154
2012-01-21 04:00:00,1,1,14.31,30.54,24.11,16,6,22
2012-01-21 05:00:00,2,4,6.5,54.99,24.43,45,98,143
2012-01-21 06:00:00,4,2,29.96,36.34,30.9,45,111,156
2012-01-21 07:00:00,2,4,14.31,88.42,44.2,35,165,200
2012-01-21 08:00:00,3,1,6.89,23.6,8.68,29,135,164
2012-01-21 09:00:00,2,4,7.24,48.48,25.23,3,183,186
2012-01-21 10:00:00,1,2,12.55,70.51,21.21,13,97,110
2012-01-21 11:00:00,2,3,10.34,93.05,14.8,45,128,173
2012-01-21 12:00:00,1,3,28.23,89.44,45.98,27,146,173
2012-01-21 13:00:00,3,3,14.65,91.62,0.41,6,18,24
2012-01-21 14:00:00,1,3,29.14,25.03,6.11,15,86,101
2012-01-21 15:00:00,2,1,10.22,87.27,36.67,13,3,16
2012-01-21 16:00:00,4,1,19.79,82.39,13.17,36,191,227
2012-01-21 17:00:00,3,2,25.64,92.19,36.16,38,129,167
2012-01-21 18:00:00,2,2,24.56,44.93,41.61,48,22,70
2012-01-21 19:00:00,3,2,23.03,92.94,12.73,26,183,209
2012-01-21 20:00:00,3,2,32.74,52.21,9.6,29,106,135
2012-01-21 21:00:00,2,4,11.86,70.73,7.27,14,81,95
2012-01-21 22:00:00,2,2,19.81,53.93,10.0,38,178,216
2012-01-21 23:00:00,4,3,31.52,54.21,13.36,41,80,121
2012-01-22 00:00:00,3,3,7.34,63.73,43.44,17,158,175
2012-01-22 01:00:00,3,3,6.68,48.47,38.5,10,57,67
2012-01-22 02:00:00,2,4,12.0,83.42,0.09,21,163,184
2012-01-22 03:00:00,1,2,23.99,70.69,43.71,45,11,56
2012-01-22 04:00:00,2,3,12.8,75.18,3.94,3,120,123
2012-01-22 05:00:00,3,3,10.71,38.48,32.76,2,162,164
2012-01-22 06:00:00,2,3,18.76,97.57,7.57,23,3,26
2012-01-22 07:00:00,4,3,23.41,72.81,3.11,13,27,40
2012-01-22 08:00:00,1,1,12.46,35.78,37.99,2,32,34
2012-01-22 09:00:00,2,2,14.02,80.04,23.36,30,73,103
2012-01-22 10:00:00,4,2,23.41,33.9,29.95,34,158,192
2012-01-22 11:00:00,3,4,33.37,25.07,21.27,30,4,34
2012-01-22 12:00:00,2,1,25.24,62.2,3.36,11,9,20
2012-01-22 13:00:00,3,4,28.49,64.28,36.98,9,152,161
2012-01-22 14:00:00,4,3,16.0,35.12,41.02,19,168,187
2012-01-22 15:00:00,3,4,13.17,47.87,2.07,17,16,33
2012-01-22 16:00:00,4,3,18.63,95.66,18.79,43,188,231
2012-01-22 17:00:00,4,3,29.21,42.8,27.87,35,59,94
2012-01-22 18:00:00,4,2,18.69,32.45,30.26,18,32,50
2012-01-22 19:00:00,2,2,30.4,99.4,28.91,16,136,152
2012-01-22 20:00:00,3,2,34.66,44.18,34.65,39,177,216
2012-01-22 21:00:00,3,2,7.16,74.42,48.34,10,158,168
2012-01-22 22:00:00,1,2,6.36,38.52,19.53,4,132,136
2012-01-22 23:00:00,1,1,9.49,64.01,27.83,36,173,209
2012-01-23 00:00:00,1,2,16.53,50.9,34.95,44,110,154
2012-01-23 01:00:00,1,4,8.93,96.93,29.62,35,131,166
2012-01-23 02:00:00,3,3,31.12,54.62,19.34,44,30,74
2012-01-23 03:00:00,4,2,5.69,66.73,31.2,47,3,50
2012-01-23 04:00:00,4,1,14.47,95.58,32.51,43,122,165
2012-01-23 05:00:00,2,4,10.54,99.14,29.25,13,17,30
2012-01-23 06:00:00,4,4,32.95,28.13,10.26,27,81,108
2012-01-23 07:00:00,3,3,25.08,86.75,25.3,8,33,41
2012-01-23 08:00:00,3,4,32.36,50.57,44.22,37,47,84
2012-01-23 09:00:00,3,4,34.17,67.59,43.43,28,62,90
2012-01-23 10:00:00,2,4,19.91,50.0,37.54,24,13,37
2012-01-23 11:00:00,1,4,12.03,52.09,34.86,7,89,96
2012-01-23 12:00:00,4,1,10.81,32.71,7.66,47,86,133
2012-01-23 13:00:00,3,3,11.69,65.82,22.97,18,32,50
2012-01-23 14:00:00,3,2,26.26,63.74,5.55,1,80,81
2012-01-23 15:00:00,1,4,6.21,35.15,40.86,5,169,174
2012-01-23 16:00:00,3,1,6.54,63.34,14.55,29,127,156
2012-01-23 17:00:00,4,3,23.24,97.85,38.34,1,159,160
2012-01-23 18:00:00,2,2,24.26,77.15,40.73,18,111,129
2012-01-23 19:00:00,3,3,24.96,58.48,44.62,12,98,110
2012-01-23 20:00:00,4,1,16.16,93.29,37.69,48,114,162
2012-01-23 21:00:00,3,1,29.18,66.03,28.24,7,170,177
2012-01-23 22:00:00,1,1,21.01,30.8,29.91,8,184,192
2012-01-23 23:00:00,3,4,8.16,63.8,16.03,22,142,164
2012-01-24 00:00:00,3,1,28.91,34.48,8.85,36,49,85
2012-01-24 01:00:00,2,2,33.59,81.4,6.53,7,115,122
2012-01-24 02:00:00,1,4,6.8,97.37,9.1,8,70,78
2012-01-24 03:00:00,1,3,16.74,48.87,46.7,15,62,77
2012-01-24 04:00:00,2,2,19.63,54.79,8.22,15,69,84
2012-01-24 05:00:00,3,4,9.39,53.72,36.19,11,136,147
2012-01-24 06:00:00,4,1,31.03,42.82,9.23,24,140,164
2012-01-24 07:00:00,1,3,13.52,83.53,48.76,10,103,113
2012-01-24 08:00:00,1,1,28.49,69.42,18.33,17,145,162
2012-01-24 09:00:00,3,2,25.13,25.12,20.61,12,162,174
2012-01-24 10:00:00,3,2,22.94,87.1,20.23,34,0,34
2012-01-24 11:00:00,1,4,10.76,34.97,40.82,17,124,141
2012-01-24 12:00:00,3,2,11.62,98.33,10.91,42,113,155
2012-01-24 13:00:00,4,3,6.42,50.13,41.55,29,35,64
2012-01-24 14:00:00,1,4,12.22,69.32,32.85,42,194,236
2012-01-24 15:00:00,4,3,15.36,26.23,11.01,36,45,81
2012-01-24 16:00:00,4,1,29.99,47.57,3.27,29,164,193
2012-01-24 17:00:00,3,3,15.99,84.19,38.75,2,199,201
2012-01-24 18:00:00,4,3,27.64,58.18,10.95,28,121,149
2012-01-24 19:00:00,3,2,18.18,92.37,44.45,24,81,105
2012-01-24 20:00:00,2,1,28.55,66.01,6.49,1,156,157
2012-01-24 21:00:00,3,2,34.29,94.29,30.82,46,43,89
2012-01-24 22:00:00,4,1,12.2,98.61,34.61,4,92,96
2012-01-24 23:00:00,2,1,30.87,56.31,32.89,30,67,97
2012-01-25 00:00:00,3,3,23.65,65.21,15.8,4,75,79
2012-01-25 01:00:00,4,2,29.52,86.79,43.78,20,76,96
2012-01-25 02:00:00,1,3,24.55,37.72,38.49,47,141,188
2012-01-25 03:00:00,1,3,17.72,88.93,25.51,48,77,125
2012-01-25 04:00:00,3,3,11.84,67.35,30.16,25,178,203
2012-01-25 05:00:00,3,1,7.1,78.04,28.32,6,85,91
2012-01-25 06:00:00,1,2,21.07,26.39,47.33,29,8,37
2012-01-25 07:00:00,4,2,34.71,81.3,44.82,33,113,146
2012-01-25 08:00:00,4,3,27.14,44.86,11.77,27,80,107
2012-01-25 09:00:00,4,1,14.82,84.42,13.14,13,87,100
2012-01-25 10:00:00,3,2,29.82,60.73,49.07,17,68,85
2012-01-25 11:00:00,2,4,28.07,41.97,11.83,43,161,204
2012-01-25 12:00:00,2,2,13.45,96.22,47.67,16,105,121
2012-01-25 13:00:00,2,3,5.43,81.2,32.49,24,64,88
2012-01-25 14:00:00,2,4,8.54,98.85,2.51,5,26,31
2012-01-25 15:00:00,2,1,31.32,49.16,16.79,4,167,171
2012-01-25 16:00:00,3,4,30.1,71.94,23.81,20,135,155
2012-01-25 17:00:00,3,4,13.86,68.93,41.65,38,5,43
2012-01-25 18:00:00,2,3,13.56,75.0,16.43,49,52,101
2012-01-25 19:00:00,3,2,28.79,23.07,15.53,19,132,151
2012-01-25 20:00:00,3,1,33.13,43.34,46.01,10,181,191
2012-01-25 21:00:00,2,4,28.37,92.75,3.95,4,116,120
2012-01-25 22:00:00,4,3,23.17,53.91,27.58,37,145,182
2012-01-25 23:00:00,3,2,12.28,96.85,25.21,38,198,236
2012-01-26 00:00:00,4,4,20.77,37.08,2.87,34,163,197
2012-01-26 01:00:00,3,3,12.01,99.79,4.39,34,96,130
2012-01-26 02:00:00,3,3,29.24,75.81,19.1,24,127,151
2012-01-26 03:00:00,2,3,16.61,82.11,6.71,29,53,82
2012-01-26 04:00:00,3,1,30.01,51.75,23.9,1,161,162
2012-01-26 05:00:00,1,2,16.45,92.56,30.44,19,31,50
2012-01-26 06:00:00,1,4,29.72,63.64,34.57,35,50,85
2012-01-26 07:00:00,2,2,15.0,74.48,27.32,36,130,166
2012-01-26 08:00:00,4,2,18.2,27.58,18.98,1,64,65
2012-01-26 09:00:00,4,4,23.46,70.53,6.49,47,84,131
2012-01-26 10:00:00,4,2,7.11,90.33,12.37,43,12,55
2012-01-26 11:00:00,1,1,33.45,34.26,20.97,46,7,53
2012-01-26 12:00:00,4,4,22.21,79.02,46.21,26,171,197
2012-01-26 13:00:00,4,4,20.23,22.03,10.13,31,157,188
2012-01-26 14:00:00,2,3,30.18,94.1,20.67,3,7,10
2012-01-26 15:00:00,4,2,30.97,98.63,36.62,26,57,83
2012-01-26 16:00:00,1,4,20.67,48.33,35.26,29,123,152
2012-01-26 17:00:00,1,4,32.82,28.57,48.28,2,90,92
2012-01-26 18:00:00,1,1,6.94,72.69,9.55,45,102,147
2012-01-26 19:00:00,2,3,8.4,22.39,0.83,44,86,130
2012-01-26 20:00:00,2,4,22.9,58.6,16.12,26,135,161
2012-01-26 21:00:00,3,1,15.62,41.74,7.48,37,60,97
2012-01-26 22:00:00,4,4,18.93,57.87,27.42,35,180,215
2012-01-26 23:00:00,2,4,14.84,21.46,44.94,0,198,198
2012-01-27 00:00:00,1,4,17.14,24.13,34.41,34,75,109
2012-01-27 01:00:00,1,1,29.68,21.28,6.79,11,113,124
2012-01-27 02:00:00,2,2,22.8,69.53,5.8,34,163,197
2012-01-27 03:00:00,2,4,34.92,64.81,45.57,17,101,118
2012-01-27 04:00:00,2,4,28.61,38.65,24.38,45,106,151
2012-01-27 05:00:00,3,2,13.21,71.73,46.18,36,93,129
2012-01-27 06:00:00,1,4,12.93,90.74,36.81,22,73,95
2012-01-27 07:00:00,3,3,15.08,42.19,49.67,32,189,221
2012-01-27 08:00:00,3,4,30.3,86.56,43.56,13,146,159
2012-01-27 09:00:00,4,3,5.82,73.0,20.71,43,17,60
2012-01-27 10:00:00,1,2,11.91,22.71,37.91,0,171,171
2012-01-27 11:00:00,1,1,32.15,50.01,23.56,26,112,138
2012-01-27 12:00:00,2,2,24.2,60.62,11.65,23,147,170
2012-01-27 13:00:00,2,4,11.81,78.54,12.05,1,1,2
2012-01-27 14:00:00,4,3,11.57,42.97,19.87,11,29,40
2012-01-27 15:00:00,3,1,30.88,98.62,5.57,12,178,190
2012-01-27 16:00:00,2,4,31.81,74.76,8.89,26,171,197
2012-01-27 17:00:00,2,1,12.68,49.83,25.03,19,46,65
2012-01-27 18:00:00,1,1,17.62,27.76,47.7,46,42,88
2012-01-27 19:00:00,1,4,30.04,34.51,28.88,47,10,57
2012-01-27 20:00:00,2,2,28.13,59.01,20.42,36,169,205
2012-01-27 21:00:00,1,4,29.42,59.58,12.14,33,18,51
2012-01-27 22:00:00,4,4,20.55,81.42,9.8,5,130,135
2012-01-27 23:00:00,2,2,32.35,78.09,32.92,7,3,10
2012-01-28 00:00:00,1,3,14.78,36.1,42.42,20,110,130
2012-01-28 01:00:00,4,4,9.7,67.6,19.94,38,165,203
2012-01-28 02:00:00,1,1,26.26,21.65,27.53,20,199,219
2012-01-28 03:00:00,1,4,21.18,51.88,35.34,44,161,205
2012-01-28 04:00:00,1,4,30.64,81.13,2.91,5,50,55
2012-01-28 05:00:00,2,1,7.43,51.96,17.54,40,158,198
2012-01-28 06:00:00,3,2,30.31,86.85,36.49,43,103,146
2012-01-28 07:00:00,1,3,13.8,98.09,34.23,29,82,111
2012-01-28 08:00:00,4,3,24.65,68.58,2.67,9,36,45
2012-01-28 09:00:00,2,1,6.2,31.6,11.89,10,171,181
2012-01-28 10:00:00,2,2,23.29,50.37,34.0,0,58,58
2012-01-28 11:00:00,4,4,26.52,20.76,13.57,9,107,116
2012-01-28 12:00:00,1,4,16.06,68.22,40.72,24,104,128
2012-01-28 13:00:00,3,4,11.46,85.73,1.48,15,17,32
2012-01-28 14:00:00,1,4,21.13,70.4,9.52,18,24,42
2012-01-28 15:00:00,4,4,30.0,82.89,14.07,9,137,146
2012-01-28 16:00:00,2,1,14.71,83.99,46.26,46,196,242
2012-01-28 17:00:00,3,4,12.57,88.08,39.82,13,24,37
2012-01-28 18:00:00,2,4,13.37,41.33,44.21,2,83,85
2012-01-28 19:00:00,4,2,33.47,89.7,22.02,3,50,53
2012-01-28 20:00:00,1,4,15.78,72.33,41.13,39,180,219
2012-01-28 21:00:00,3,3,5.11,43.18,42.67,32,9,41
2012-01-28 22:00:00,2,1,28.45,98.98,20.0,19,176,195
2012-01-28 23:00:00,2,1,25.98,96.01,49.72,14,124,138
2012-01-29 00:00:00,2,1,8.86,65.96,42.56,6,165,171
2012-01-29 01:00:00,1,3,34.55,87.46,48.7,43,91,134
2012-01-29 02:00:00,3,4,23.24,40.92,43.32,2,125,127
2012-01-29 03:00:00,1,1,20.02,53.28,38.81,26,112,138
2012-01-29 04:00:00,1,3,16.47,34.72,47.19,36,113,149
2012-01-29 05:00:00,1,2,31.96,61.61,20.99,28,45,73
2012-01-29 06:00:00,4,4,12.32,59.68,39.17,25,69,94
2012-01-29 07:00:00,4,3,13.57,37.03,10.64,26,10,36
2012-01-29 08:00:00,4,4,8.67,73.82,36.64,24,82,106
2012-01-29 09:00:00,3,2,27.77,29.42,39.27,39,143,182
2012-01-29 10:00:00,1,3,22.87,24.94,35.83,42,159,201
2012-01-29 11:00:00,1,4,23.27,50.79,42.49,29,129,158
2012-01-29 12:00:00,4,3,11.55,52.79,20.67,43,57,100
2012-01-29 13:00:00,1,1,24.54,45.58,27.24,19,84,103
2012-01-29 14:00:00,1,4,27.96,40.64,0.53,6,165,171
2012-01-29 15:00:00,2,3,15.74,47.1,7.3,28,78,106
2012-01-29 16:00:00,1,1,29.04,33.07,32.21,45,184,229
2012-01-29 17:00:00,2,2,15.46,52.28,28.12,33,76,109
2012-01-29 18:00:00,1,4,27.74,92.37,9.87,25,70,95
2012-01-29 19:00:00,3,4,6.01,37.95,12.17,26,115,141
2012-01-29 20:00:00,4,2,21.53,74.76,17.2,43,186,229
2012-01-29 21:00:00,2,1,34.09,31.34,35.82,8,184,192
2012-01-29 22:00:00,4,2,34.44,48.31,30.49,21,66,87
2012-01-29 23:00:00,2,4,13.45,45.69,3.48,11,14,25
2012-01-30 00:00:00,2,3,18.24,94.96,38.0,5,83,88
2012-01-30 01:00:00,2,1,6.89,54.24,13.13,5,185,190
2012-01-30 02:00:00,3,1,31.2,75.24,33.59,26,2,28
2012-01-30 03:00:00,1,1,22.06,68.2,6.17,18,57,75
2012-01-30 04:00:00,2,2,16.55,31.28,49.9,5,26,31
2012-01-30 05:00:00,3,2,8.38,95.16,4.02,48,142,190
2012-01-30 06:00:00,2,3,33.4,47.67,37.09,16,187,203
2012-01-30 07:00:00,1,3,20.91,23.58,27.07,28,2,30
2012-01-30 08:00:00,2,1,13.49,44.04,4.3,22,155,177
2012-01-30 09:00:00,3,3,15.51,46.85,1.34,16,174,190
2012-01-30 10:00:00,1,2,13.12,27.42,18.13,20,64,84
2012-01-30 11:00:00,3,3,23.05,69.6,40.11,9,180,189
2012-01-30 12:00:00,1,2,32.9,47.74,2.06,42,147,189
2012-01-30 13:00:00,1,3,30.7,70.33,35.22,7,10,17
2012-01-30 14:00:00,4,4,18.81,20.54,32.77,13,24,37
2012-01-30 15:00:00,4,2,29.79,98.56,13.28,30,190,220
2012-01-30 16:00:00,4,4,17.69,33.64,3.87,17,3,20
2012-01-30 17:00:00,1,2,12.57,72.75,45.77,46,82,128
2012-01-30 18:00:00,2,3,34.5,77.26,15.02,29,53,82
2012-01-30 19:00:00,3,4,14.12,33.73,5.57,17,59,76
2012-01-30 20:00:00,3,3,14.71,28.94,34.08,24,155,179
2012-01-30 21:00:00,3,2,34.69,32.21,10.83,48,137,185
2012-01-30 22:00:00,4,4,9.02,39.75,23.78,36,163,199
2012-01-30 23:00:00,1,1,27.82,33.46,2.52,24,79,103
2012-01-31 00:00:00,4,3,33.07,73.92,49.65,29,160,189
2012-01-31 01:00:00,2,2,20.35,53.67,22.38,29,58,87
2012-01-31 02:00:00,1,4,5.08,63.02,49.96,35,172,207
2012-01-31 03:00:00,3,3,16.25,23.79,19.28,10,178,188
2012-01-31 04:00:00,4,4,8.35,88.9,17.39,47,45,92
2012-01-31 05:00:00,4,3,17.49,33.65,45.73,38,140,178
2012-01-31 06:00:00,2,3,28.7,48.81,16.47,26,92,118
2012-01-31 07:00:00,2,3,18.16,25.75,21.6,15,131,146
2012-01-31 08:00:00,4,4,17.96,30.94,3.91,37,169,206
2012-01-31 09:00:00,2,4,21.7,73.26,47.77,31,154,185
2012-01-31 10:00:00,3,3,22.45,75.41,4.26,28,135,163
2012-01-31 11:00:00,2,1,30.69,74.16,38.56,9,104,113
2012-01-31 12:00:00,2,1,14.25,64.17,26.93,29,45,74
2012-01-31 13:00:00,4,1,29.65,96.2,3.07,10,135,145
2012-01-31 14:00:00,4,2,21.98,60.57,0.09,14,25,39
2012-01-31 15:00:00,1,1,14.02,55.95,46.78,43,0,43
2012-01-31 16:00:00,1,4,13.85,39.8,37.11,22,111,133
2012-01-31 17:00:00,4,1,15.83,27.91,34.32,47,188,235
2012-01-31 18:00:00,2,4,23.68,63.85,21.93,22,89,111
2012-01-31 19:00:00,2,2,11.92,45.19,11.93,49,38,87
2012-01-31 20:00:00,1,4,32.61,61.92,33.99,6,136,142
2012-01-31 21:00:00,1,4,22.25,36.49,30.42,13,26,39
2012-01-31 22:00:00,1,4,32.6,87.05,36.32,8,197,205
2012-01-31 23:00:00,3,1,6.39,99.98,18.29,27,147,174
2012-02-01 00:00:00,3,3,15.28,45.79,49.35,5,192,197
2012-02-01 01:00:00,1,4,5.68,87.39,3.35,42,15,57
2012-02-01 02:00:00,2,1,13.17,89.84,3.99,44,195,239
2012-02-01 03:00:00,1,1,30.86,99.69,45.84,21,66,87
2012-02-01 04:00:00,3,1,6.1,47.42,32.39,17,21,38
2012-02-01 05:00:00,2,3,18.08,80.48,16.32,43,72,115
2012-02-01 06:00:00,3,3,8.53,38.3,38.1,37,183,220
2012-02-01 07:00:00,2,3,17.51,69.98,22.64,21,119,140
2012-02-01 08:00:00,3,3,30.17,76.39,1.06,8,184,192
2012-02-01 09:00:00,2,2,23.69,79.29,32.56,17,181,198
2012-02-01 10:00:00,2,3,27.1,36.57,12.16,20,135,155
2012-02-01 11:00:00,2,3,15.47,87.9,5.77,14,134,148
2012-02-01 12:00:00,2,3,33.33,53.68,11.26,8,75,83
2012-02-01 13:00:00,4,4,26.28,37.31,23.81,41,0,41
2012-02-01 14:00:00,3,4,17.65,63.4,2.49,1,181,182
2012-02-01 15:00:00,3,3,17.79,89.07,44.16,13,139,152
2012-02-01 16:00:00,4,2,32.56,97.37,28.0,20,13,33
2012-02-01 17:00:00,2,4,22.29,79.86,14.65,42,146,188
2012-02-01 18:00:00,2,1,26.19,20.45,34.35,44,18,62
2012-02-01 19:00:00,3,4,17.51,30.78,40.21,33,76,109
2012-02-01 20:00:00,4,1,11.71,26.1,30.7,6,107,113
2012-02-01 21:00:00,2,4,26.71,28.1,10.12,14,73,87
2012-02-01 22:00:00,2,3,23.23,50.64,5.51,38,110,148
2012-02-01 23:00:00,2,4,20.04,47.08,42.99,11,124,135
2012-02-02 00:00:00,1,3,23.72,29.09,11.73,6,92,98
2012-02-02 01:00:00,4,3,11.25,90.58,1.0,4,155,159
2012-02-02 02:00:00,2,4,28.82,69.23,32.15,46,142,188
2012-02-02 03:00:00,1,1,33.44,83.72,7.64,38,62,100
2012-02-02 04:00:00,4,1,31.73,49.72,49.55,22,22,44
2012-02-02 05:00:00,2,4,14.64,52.82,43.49,27,170,197
2012-02-02 06:00:00,3,3,17.18,45.41,30.42,33,9,42
2012-02-02 07:00:00,1,1,29.25,55.07,41.69,24,163,187
2012-02-02 08:00:00,1,2,22.85,68.83,23.53,1,190,191
2012-02-02 09:00:00,2,3,21.44,59.44,39.42,8,176,184
2012-02-02 10:00:00,2,4,32.8,87.03,32.33,33,141,174
2012-02-02 11:00:00,1,3,21.08,92.01,1.43,45,95,140
2012-02-02 12:00:00,3,2,20.45,57.57,47.44,46,33,79
2012-02-02 13:00:00,3,2,6.26,39.18,43.05,31,94,125
2012-02-02 14:00:00,4,1,7.08,95.62,47.67,11,38,49
2012-02-02 15:00:00,2,2,5.22,78.8,36.57,18,159,177
2012-02-02 16:00:00,3,3,32.4,71.21,20.6,46,79,125
2012-02-02 17:00:00,4,1,17.25,79.63,10.35,37,149,186
2012-02-02 18:00:00,3,2,19.06,26.08,9.0,9,99,108
2012-02-02 19:00:00,2,1,30.36,25.41,7.25,9,162,171
2012-02-02 20:00:00,4,1,23.28,32.25,11.03,34,22,56
2012-02-02 21:00:00,4,4,23.29,31.8,27.53,40,24,64
2012-02-02 22:00:00,4,1,13.9,53.65,34.19,36,196,232
2012-02-02 23:00:00,3,1,30.02,32.59,15.7,31,133,164
2012-02-03 00:00:00,2,2,9.97,88.36,27.44,6,89,95
2012-02-03 01:00:00,4,3,6.59,66.25,17.06,9,187,196
2012-02-03 02:00:00,1,3,10.75,49.46,34.83,42,5,47
2012-02-03 03:00:00,2,2,13.03,25.57,49.42,37,18,55
2012-02-03 04:00:00,1,3,13.47,67.28,34.45,26,18,44
2012-02-03 05:00:00,1,1,25.12,29.32,2.95,31,109,140
2012-02-03 06:00:00,4,4,11.53,79.46,23.86,6,110,116
2012-02-03 07:00:00,4,1,25.3,84.22,38.52,47,94,141
2012-02-03 08:00:00,3,1,7.73,63.52,27.11,25,86,111
2012-02-03 09:00:00,3,4,9.42,31.97,47.55,21,139,160
2012-02-03 10:00:00,3,2,20.26,82.95,2.74,11,12,23
2012-02-03 11:00:00,2,1,32.66,44.63,14.56,23,85,108
2012-02-03 12:00:00,3,1,30.79,37.81,11.04,49,177,226
2012-02-03 13:00:00,1,2,34.06,57.64,38.38,45,194,239
2012-02-03 14:00:00,3,1,24.51,93.81,26.19,28,75,103
2012-02-03 15:00:00,4,1,25.27,43.79,6.92,31,158,189
2012-02-03 16:00:00,3,3,23.75,92.45,14.28,15,76,91
2012-02-03 17:00:00,2,2,23.68,24.29,26.13,25,22,47
2012-02-03 18:00:00,2,1,9.41,26.68,49.81,5,69,74
2012-02-03 19:00:00,1,1,21.31,75.88,18.21,0,124,124
2012-02-03 20:00:00,2,4,16.58,35.25,7.84,12,57,69
2012-02-03 21:00:00,3,4,18.28,45.33,24.85,37,194,231
2012-02-03 22:00:00,4,4,20.71,30.91,15.51,5,198,203
2012-02-03 23:00:00,2,1,8.85,46.58,28.3,37,137,174
2012-02-04 00:00:00,1,1,15.78,42.44,23.34,11,67,78
2012-02-04 01:00:00,3,4,6.9,78.91,34.47,8,171,179
2012-02-04 02:00:00,1,3,34.39,76.16,45.71,19,69,88
2012-02-04 03:00:00,2,3,8.56,96.39,10.03,38,81,119
2012-02-04 04:00:00,2,3,12.76,77.95,41.06,26,198,224
2012-02-04 05:00:00,1,3,31.74,75.59,47.46,2,7,9
2012-02-04 06:00:00,3,2,19.48,75.54,18.68,23,113,136
2012-02-04 07:00:00,2,4,9.07,90.64,5.68,14,27,41
2012-02-04 08:00:00,4,1,16.53,43.7,41.1,33,182,215
2012-02-04 09:00:00,2,4,8.48,44.01,35.05,49,66,115
2012-02-04 10:00:00,3,3,11.01,79.3,10.64,31,166,197
2012-02-04 11:00:00,2,1,6.56,38.3,22.26,20,160,180
2012-02-04 12:00:00,1,2,18.15,92.96,28.9,0,113,113
2012-02-04 13:00:00,2,4,29.2,62.78,8.49,32,79,111
2012-02-04 14:00:00,2,1,22.58,44.01,35.75,10,156,166
2012-02-04 15:00:00,3,1,23.19,82.09,34.49,2,144,146
2012-02-04 16:00:00,1,3,11.02,44.99,44.36,21,164,185
2012-02-04 17:00:00,3,3,15.32,97.06,28.36,9,133,142
2012-02-04 18:00:00,2,4,30.36,98.64,28.72,43,173,216
2012-02-04 19:00:00,4,2,7.64,73.34,30.97,37,13,50
2012-02-04 20:00:00,2,1,30.74,29.09,13.69,23,164,187
2012-02-04 21:00:00,3,3,19.51,41.06,37.93,6,113,119
2012-02-04 22:00:00,4,4,30.11,61.23,33.12,48,106,154
2012-02-04 23:00:00,3,3,14.54,88.12,41.96,48,75,123
2012-02-05 00:00:00,3,4,15.17,34.79,38.43,35,82,117
2012-02-05 01:00:00,1,3,27.55,28.35,31.93,0,84,84
2012-02-05 02:00:00,4,2,28.55,25.96,8.04,0,28,28
2012-02-05 03:00:00,2,1,11.89,60.56,45.96,25,48,73
2012-02-05 04:00:00,3,3,34.19,90.78,18.36,16,1,17
2012-02-05 05:00:00,2,1,7.53,23.39,48.21,10,197,207
2012-02-05 06:00:00,1,4,7.06,36.99,20.09,2,88,90
2012-02-05 07:00:00,1,2,22.87,75.46,7.3,9,69,78
2012-02-05 08:00:00,4,1,26.68,86.07,44.24,1,192,193
2012-02-05 09:00:00,1,3,33.83,84.59,39.75,31,45,76
2012-02-05 10:00:00,1,1,17.15,82.81,39.31,15,62,77
2012-02-05 11:00:00,2,1,5.76,30.38,4.47,47,118,165
2012-02-05 12:00:00,1,4,23.09,51.78,43.96,25,84,109
2012-02-05 13:00:00,1,2,13.69,98.78,29.82,39,148,187
2012-02-05 14:00:00,3,2,17.99,99.11,23.52,38,26,64
2012-02-05 15:00:00,1,1,19.65,68.19,45.66,9,190,199
2012-02-05 16:00:00,3,1,6.94,76.74,33.3,35,22,57
2012-02-05 17:00:00,1,4,19.58,96.1,6.65,29,99,128
2012-02-05 18:00:00,1,1,17.79,55.99,25.98,8,38,46
2012-02-05 19:00:00,4,4,26.38,30.95,31.83,4,57,61
2012-02-05 20:00:00,4,2,24.37,73.52,44.93,6,44,50
2012-02-05 21:00:00,3,2,10.56,96.81,13.99,35,141,176
2012-02-05 22:00:00,1,4,11.18,75.78,39.71,0,149,149
2012-02-05 23:00:00,2,1,12.53,84.27,39.99,26,16,42
2012-02-06 00:00:00,4,2,10.37,53.82,6.4,11,156,167
2012-02-06 01:00:00,2,3,24.72,27.72,0.86,15,37,52
2012-02-06 02:00:00,4,4,34.83,33.51,29.07,47,89,136
2012-02-06 03:00:00,4,2,24.56,98.61,39.47,7,30,37
2012-02-06 04:00:00,1,2,23.2,59.45,27.72,24,97,121
2012-02-06 05:00:00,4,2,17.3,20.96,40.67,12,57,69
2012-02-06 06:00:00,2,3,14.38,96.43,31.12,40,90,130
2012-02-06 07:00:00,4,3,32.33,59.82,32.66,9,16,25
2012-02-06 08:00:00,3,3,34.07,86.9,1.41,39,119,158
2012-02-06 09:00:00,1,1,19.9,63.88,4.43,32,22,54
2012-02-06 10:00:00,1,4,13.71,28.14,36.25,34,147,181
2012-02-06 11:00:00,3,1,28.1,69.25,38.14,36,95,131
2012-02-06 12:00:00,3,3,8.97,99.79,27.11,38,3,41
2012-02-06 13:00:00,3,4,27.97,22.78,29.51,27,72,99
2012-02-06 14:00:00,4,1,29.57,87.34,30.72,15,74,89
2012-02-06 15:00:00,1,1,8.75,38.84,5.25,7,48,55
2012-02-06 16:00:00,3,1,34.31,51.51,33.4,32,108,140
2012-02-06 17:00:00,4,3,34.57,49.82,23.92,34,25,59
2012-02-06 18:00:00,3,2,33.1,91.9,30.13,37,31,68
2012-02-06 19:00:00,2,4,19.88,60.36,28.16,11,27,38
2012-02-06 20:00:00,2,3,12.38,55.77,38.15,14,50,64
2012-02-06 21:00:00,1,4,22.46,85.44,15.93,16,167,183
2012-02-06 22:00:00,4,3,17.6,23.91,18.68,26,36,62
2012-02-06 23:00:00,2,1,11.18,26.92,19.58,49,178,227
2012-02-07 00:00:00,2,1,17.71,21.74,38.12,20,56,76
2012-02-07 01:00:00,4,2,24.92,75.04,21.56,20,79,99
2012-02-07 02:00:00,3,2,7.13,62.05,8.85,16,71,87
2012-02-07 03:00:00,4,4,15.0,90.08,49.15,26,194,220
2012-02-07 04:00:00,3,2,5.53,59.88,24.67,11,2,13
2012-02-07 05:00:00,2,2,27.48,37.75,5.46,47,190,237
2012-02-07 06:00:00,2,4,24.22,84.41,33.51,43,139,182
2012-02-07 07:00:00,2,3,6.88,43.55,36.96,35,110,145
2012-02-07 08:00:00,1,2,33.94,94.86,25.01,27,90,117
2012-02-07 09:00:00,1,3,5.68,40.03,32.32,24,50,74
2012-02-07 10:00:00,1,1,22.7,33.42,8.63,8,138,146
2012-02-07 11:00:00,4,2,28.29,59.47,18.4,46,133,179
2012-02-07 12:00:00,2,1,28.64,24.04,8.09,36,139,175
2012-02-07 13:00:00,2,1,6.03,22.91,19.36,22,24,46
2012-02-07 14:00:00,4,3,32.19,59.68,28.14,10,25,35
2012-02-07 15:00:00,1,4,32.55,37.21,22.13,49,185,234
2012-02-07 16:00:00,4,2,21.84,20.75,29.66,0,79,79
2012-02-07 17:00:00,1,3,19.46,43.68,25.09,15,35,50
2012-02-07 18:00:00,2,4,6.35,58.19,15.89,49,163,212
2012-02-07 19:00:00,3,1,21.86,51.54,7.17,12,20,32
2012-02-07 20:00:00,1,2,17.28,30.84,12.63,19,48,67
2012-02-07 21:00:00,2,1,28.18,66.37,10.04,15,83,98
2012-02-07 22:00:00,2,1,17.12,76.83,35.37,15,117,132
2012-02-07 23:00:00,3,2,25.51,74.04,41.0,34,59,93
2012-02-08 00:00:00,2,4,8.04,51.5,36.02,49,105,154
2012-02-08 01:00:00,2,4,8.99,31.01,32.19,31,189,220
2012-02-08 02:00:00,1,2,9.19,59.96,15.39,22,122,144
2012-02-08 03:00:00,1,2,6.37,91.23,35.55,24,18,42
2012-02-08 04:00:00,3,3,21.24,57.5,30.25,42,138,180
2012-02-08 05:00:00,3,3,28.82,35.65,2.34,27,77,104
2012-02-08 06:00:00,2,1,23.31,27.44,45.38,44,99,143
2012-02-08 07:00:00,1,2,22.25,95.51,4.0,1,130,131
2012-02-08 08:00:00,3,4,25.42,79.44,25.14,2,184,186
2012-02-08 09:00:00,3,1,15.19,45.04,25.65,30,127,157
2012-02-08 10:00:00,4,1,15.86,43.63,41.85,32,106,138
2012-02-08 11:00:00,3,1,14.43,91.62,45.65,32,196,228
2012-02-08 12:00:00,2,1,26.36,34.21,46.98,46,180,226
2012-02-08 13:00:00,1,4,9.85,62.8,28.48,34,193,227
2012-02-08 14:00:00,3,1,5.39,77.08,33.95,35,139,174
2012-02-08 15:00:00,4,2,22.89,51.71,4.43,25,61,86
2012-02-08 16:00:00,1,3,33.27,23.19,24.4,11,44,55
2012-02-08 17:00:00,3,4,23.28,38.22,44.89,43,56,99
2012-02-08 18:00:00,4,2,28.49,92.14,22.78,45,129,174
2012-02-08 19:00:00,3,2,25.18,61.85,3.48,10,100,110
2012-02-08 20:00:00,1,2,19.92,85.24,10.03,5,182,187
2012-02-08 21:00:00,1,3,26.55,64.45,21.48,24,18,42
2012-02-08 22:00:00,1,3,29.72,95.49,11.88,45,60,105
2012-02-08 23:00:00,2,3,11.74,92.73,19.61,33,151,184
2012-02-09 00:00:00,3,2,15.08,58.63,16.65,34,4,38
2012-02-09 01:00:00,2,3,11.71,45.46,15.95,20,153,173
2012-02-09 02:00:00,1,1,18.57,68.13,4.56,17,162,179
2012-02-09 03:00:00,4,3,31.55,73.99,44.14,7,18,25
2012-02-09 04:00:00,3,4,15.36,59.87,34.64,33,30,63
2012-02-09 05:00:00,2,2,16.23,85.78,31.17,47,171,218
2012-02-09 06:00:00,3,2,30.81,34.67,30.32,13,146,159
2012-02-09 07:00:00,4,1,20.46,46.75,19.83,18,105,123
2012-02-09 08:00:00,2,3,21.06,74.91,41.17,19,80,99
2012-02-09 09:00:00,1,3,30.82,39.73,46.5,3,139,142
2012-02-09 10:00:00,2,4,19.72,55.19,0.28,37,162,199
2012-02-09 11:00:00,3,1,25.45,97.1,3.96,31,89,120
2012-02-09 12:00:00,3,4,7.57,70.07,33.75,25,185,210
2012-02-09 13:00:00,3,4,10.36,95.92,11.8,27,116,143
2012-02-09 14:00:00,3,2,17.13,77.8,45.59,11,124,135
2012-02-09 15:00:00,1,2,19.85,77.97,33.37,9,71,80
2012-02-09 16:00:00,2,3,33.97,67.35,18.41,40,103,143
2012-02-09 17:00:00,1,3,34.12,31.38,20.76,34,24,58
2012-02-09 18:00:00,1,4,30.54,61.58,34.54,32,152,184
2012-02-09 19:00:00,1,3,14.47,40.21,7.05,13,140,153
2012-02-09 20:00:00,3,4,33.92,99.89,44.17,39,41,80
2012-02-09 21:00:00,3,3,25.68,41.36,0.24,22,142,164
2012-02-09 22:00:00,3,3,16.79,38.45,48.95,17,22,39
2012-02-09 23:00:00,2,2,26.05,69.91,8.38,43,27,70
2012-02-10 00:00:00,4,2,5.5,60.88,37.11,11,111,122
2012-02-10 01:00:00,3,2,9.38,21.71,2.0,41,12,53
2012-02-10 02:00:00,2,2,29.89,30.36,21.57,35,95,130
2012-02-10 03:00:00,3,1,24.37,84.88,31.52,24,74,98
2012-02-10 04:00:00,3,2,15.93,58.7,3.51,36,171,207
2012-02-10 05:00:00,1,1,20.02,31.68,22.16,39,179,218
2012-02-10 06:00:00,1,2,32.15,57.22,15.16,21,34,55
2012-02-10 07:00:00,1,3,23.95,40.25,24.91,5,46,51
2012-02-10 08:00:00,2,4,16.94,37.89,25.23,15,162,177
2012-02-10 09:00:00,4,3,8.61,96.62,39.26,22,49,71
2012-02-10 10:00:00,4,3,13.81,48.96,6.18,8,86,94
2012-02-10 11:00:00,2,1,34.35,23.71,4.14,42,39,81
2012-02-10 12:00:00,3,2,18.12,97.63,20.09,34,76,110
2012-02-10 13:00:00,2,4,19.16,83.59,44.38,28,197,225
2012-02-10 14:00:00,3,4,19.96,40.35,42.76,13,41,54
2012-02-10 15:00:00,2,2,31.52,52.71,28.0,4,142,146
2012-02-10 16:00:00,2,1,23.12,88.98,44.44,20,59,79
2012-02-10 17:00:00,2,1,25.81,48.59,40.27,5,57,62
2012-02-10 18:00:00,4,1,16.68,65.39,13.9,0,196,196
2012-02-10 19:00:00,1,4,5.87,62.79,8.51,30,32,62
2012-02-10 20:00:00,2,1,32.93,52.1,15.06,44,167,211
2012-02-10 21:00:00,4,1,33.47,71.16,11.36,40,1,41
2012-02-10 22:00:00,1,4,33.47,57.86,31.14,27,160,187
2012-02-10 23:00:00,1,4,33.31,21.7,29.24,2,152,154
2012-02-11 00:00:00,2,3,29.46,85.15,29.92,37,58,95
2012-02-11 01:00:00,3,4,25.54,29.05,9.47,22,154,176
2012-02-11 02:00:00,3,2,30.34,57.13,39.59,39,183,222
2012-02-11 03:00:00,3,4,23.02,66.39,21.68,3,111,114
2012-02-11 04:00:00,2,4,9.03,76.44,23.62,5,24,29
2012-02-11 05:00:00,3,1,16.74,52.86,49.85,11,132,143
2012-02-11 06:00:00,4,3,34.14,78.84,14.11,11,61,72
2012-02-11 07:00:00,4,1,15.53,30.51,19.71,6,170,176
2012-02-11 08:00:00,4,3,31.03,72.28,33.82,27,103,130
2012-02-11 09:00:00,4,1,7.8,86.11,44.02,25,195,220
2012-02-11 10:00:00,1,2,15.03,91.16,6.34,47,77,124
2012-02-11 11:00:00,4,1,15.53,66.37,36.75,6,104,110
2012-02-11 12:00:00,3,1,6.55,45.03,45.91,2,90,92
2012-02-11 13:00:00,2,2,8.57,33.07,21.15,12,163,175
2012-02-11 14:00:00,3,2,10.79,47.64,14.34,40,123,163
2012-02-11 15:00:00,4,4,30.13,63.2,33.89,10,97,107
2012-02-11 16:00:00,1,1,6.9,35.71,12.3,38,137,175
2012-02-11 17:00:00,4,2,13.96,96.2,19.21,22,114,136
2012-02-11 18:00:00,2,2,5.31,91.77,44.85,46,149,195
2012-02-11 19:00:00,3,4,25.87,22.64,29.52,0,85,85
2012-02-11 20:00:00,2,3,23.61,64.96,4.75,33,27,60
2012-02-11 21:00:00,2,2,24.35,83.14,16.48,30,47,77
2012-02-11 22:00:00,2,2,16.23,39.63,31.36,32,187,219
2012-02-11 23:00:00,3,1,11.25,61.91,24.07,46,83,129
2012-02-12 00:00:00,4,4,26.61,52.48,33.02,35,62,97
2012-02-12 01:00:00,2,1,29.33,35.72,38.07,35,1,36
2012-02-12 02:00:00,3,3,9.16,69.18,24.03,13,22,35
2012-02-12 03:00:00,1,4,19.6,99.5,49.35,36,50,86
2012-02-12 04:00:00,3,1,12.46,49.22,45.73,31,111,142
2012-02-12 05:00:00,1,2,10.04,64.19,3.0,27,79,106
2012-02-12 06:00:00,3,2,27.03,46.23,13.32,0,155,155
2012-02-12 07:00:00,4,4,21.14,90.16,15.03,46,115,161
2012-02-12 08:00:00,2,2,11.49,89.17,9.21,6,0,6
2012-02-12 09:00:00,4,1,14.3,34.3,15.6,15,142,157
2012-02-12 10:00:00,3,4,34.0,92.0,21.24,31,14,45
2012-02-12 11:00:00,2,2,30.46,32.12,2.58,23,42,65
2012-02-12 12:00:00,1,2,31.4,27.64,6.37,13,132,145
2012-02-12 13:00:00,3,3,18.8,72.23,4.81,46,199,245
2012-02-12 14:00:00,2,3,23.71,50.87,2.32,14,102,116
2012-02-12 15:00:00,1,4,16.3,62.46,24.07,0,124,124
2012-02-12 16:00:00,1,3,7.33,72.21,16.69,27,37,64
2012-02-12 17:00:00,4,1,17.03,24.23,46.77,18,62,80
2012-02-12 18:00:00,3,2,22.82,43.44,5.14,6,170,176
2012-02-12 19:00:00,1,2,13.61,56.87,46.3,17,50,67
2012-02-12 20:00:00,2,2,30.44,41.33,4.33,46,77,123
2012-02-12 21:00:00,1,4,9.53,23.92,30.96,12,82,94
2012-02-12 22:00:00,1,4,16.01,26.93,12.39,17,153,170
2012-02-12 23:00:00,4,3,8.75,84.14,41.34,3,96,99
2012-02-13 00:00:00,4,2,17.14,92.91,3.07,49,173,222
2012-02-13 01:00:00,2,2,6.19,32.18,47.63,3,139,142
2012-02-13 02:00:00,4,2,13.18,39.94,2.36,26,92,118
2012-02-13 03:00:00,1,2,17.02,72.18,12.06,15,139,154
2012-02-13 04:00:00,1,2,19.34,96.34,23.21,13,28,41
2012-02-13 05:00:00,4,1,21.31,43.97,37.8,13,104,117
2012-02-13 06:00:00,1,2,13.25,88.42,47.56,6,60,66
2012-02-13 07:00:00,1,1,20.69,60.48,21.4,44,40,84
2012-02-13 08:00:00,2,2,20.27,96.52,37.87,13,147,160
2012-02-13 09:00:00,4,4,14.49,30.9,36.36,41,45,86
2012-02-13 10:00:00,1,4,29.91,97.89,28.56,44,157,201
2012-02-13 11:00:00,4,1,21.37,55.28,34.55,5,38,43
2012-02-13 12:00:00,2,2,14.97,96.24,1.9,42,39,81
2012-02-13 13:00:00,4,4,33.42,56.7,22.08,37,178,215
2012-02-13 14:00:00,1,4,30.35,62.41,39.29,26,1,27
2012-02-13 15:00:00,4,2,34.48,84.38,23.71,10,192,202
2012-02-13 16:00:00,1,2,25.77,77.81,43.68,30,155,185
2012-02-13 17:00:00,1,4,16.35,69.57,41.68,48,50,98
2012-02-13 18:00:00,1,2,13.43,53.36,43.17,2,119,121
2012-02-13 19:00:00,2,3,24.9,83.4,6.5,0,7,7
2012-02-13 20:00:00,4,2,34.42,95.86,12.21,15,30,45
2012-02-13 21:00:00,2,4,23.8,20.78,1.48,43,38,81
2012-02-13 22:00:00,4,4,31.45,67.03,49.14,26,187,213
2012-02-13 23:00:00,2,1,14.87,89.28,11.81,45,82,127
2012-02-14 00:00:00,3,3,17.21,72.25,18.35,49,143,192
2012-02-14 01:00:00,1,4,32.19,84.07,13.75,2,22,24
2012-02-14 02:00:00,1,3,27.71,91.6,1.99,7,138,145
2012-02-14 03:00:00,2,2,34.44,80.08,13.06,49,120,169
2012-02-14 04:00:00,3,4,28.24,77.36,4.91,15,181,196
2012-02-14 05:00:00,1,1,18.46,97.18,19.71,46,68,114
2012-02-14 06:00:00,4,4,20.93,89.09,48.34,1,11,12
2012-02-14 07:00:00,2,1,32.02,85.23,34.91,28,35,63
2012-02-14 08:00:00,1,3,21.55,26.91,35.35,15,56,71
2012-02-14 09:00:00,1,1,12.66,39.12,22.66,28,153,181
2012-02-14 10:00:00,2,2,18.07,64.54,40.57,30,91,121
2012-02-14 11:00:00,2,2,20.49,76.76,45.41,41,193,234
2012-02-14 12:00:00,4,2,7.9,44.26,48.08,10,89,99
2012-02-14 13:00:00,4,4,27.31,27.47,4.95,31,3,34
2012-02-14 14:00:00,1,2,8.28,44.89,43.98,23,143,166
2012-02-14 15:00:00,1,2,17.15,81.68,11.25,18,21,39
2012-02-14 16:00:00,2,4,29.14,90.19,19.86,31,191,222
2012-02-14 17:00:00,1,3,19.03,93.03,17.27,9,106,115
2012-02-14 18:00:00,1,2,30.26,50.31,33.76,48,69,117
2012-02-14 19:00:00,2,2,15.26,49.8,29.9,31,138,169
2012-02-14 20:00:00,1,4,33.73,52.54,5.46,22,169,191
2012-02-14 21:00:00,1,3,11.28,50.06,39.14,32,84,116
2012-02-14 22:00:00,3,3,6.15,73.3,21.98,29,38,67
2012-02-14 23:00:00,4,3,31.17,48.67,0.11,29,174,203
2012-02-15 00:00:00,2,4,27.57,21.63,20.73,6,149,155
2012-02-15 01:00:00,3,1,11.96,55.12,25.82,15,29,44
2012-02-15 02:00:00,4,1,34.54,37.93,3.44,42,157,199
2012-02-15 03:00:00,4,2,20.07,22.3,7.56,49,160,209
2012-02-15 04:00:00,4,2,33.53,57.67,49.68,0,103,103
2012-02-15 05:00:00,3,2,20.15,36.48,43.56,29,157,186
2012-02-15 06:00:00,3,1,19.16,56.22,6.67,33,164,197
2012-02-15 07:00:00,4,4,18.47,42.22,29.02,33,52,85
2012-02-15 08:00:00,1,2,15.05,68.3,18.96,37,157,194
2012-02-15 09:00:00,1,4,21.01,99.27,27.19,30,153,183
2012-02-15 10:00:00,3,2,18.58,63.78,23.53,7,133,140
2012-02-15 11:00:00,3,4,6.1,71.75,2.41,19,53,72
2012-02-15 12:00:00,3,4,12.81,93.54,15.77,45,183,228
2012-02-15 13:00:00,4,1,11.39,49.92,6.28,28,131,159
2012-02-15 14:00:00,1,4,31.02,33.32,24.45,30,78,108
2012-02-15 15:00:00,3,3,22.97,42.62,45.37,20,35,55
2012-02-15 16:00:00,3,1,27.91,52.22,49.78,25,62,87
2012-02-15 17:00:00,2,2,33.7,71.6,47.21,30,130,160
2012-02-15 18:00:00,4,1,24.32,20.37,49.28,19,56,75
2012-02-15 19:00:00,2,3,34.48,88.27,0.76,21,79,100
2012-02-15 20:00:00,1,3,14.35,26.09,36.47,39,15,54
2012-02-15 21:00:00,2,4,10.59,92.05,13.65,25,167,192
2012-02-15 22:00:00,2,3,17.1,95.95,43.28,16,180,196
2012-02-15 23:00:00,2,3,19.12,99.21,40.69,24,119,143
2012-02-16 00:00:00,4,3,31.86,84.76,21.18,36,133,169
2012-02-16 01:00:00,1,3,21.8,31.35,23.66,26,148,174
2012-02-16 02:00:00,2,2,13.77,76.49,13.25,2,8,10
2012-02-16 03:00:00,4,2,27.28,36.27,14.44,23,190,213
2012-02-16 04:00:00,1,1,20.17,91.77,49.06,24,170,194
2012-02-16 05:00:00,3,4,9.86,45.33,44.44,49,199,248
2012-02-16 06:00:00,2,2,22.3,46.14,9.59,9,27,36
2012-02-16 07:00:00,1,3,32.34,93.41,13.78,35,44,79
2012-02-16 08:00:00,2,4,30.28,21.06,5.43,41,57,98
2012-02-16 09:00:00,3,2,22.6,35.52,49.44,17,28,45
2012-02-16 10:00:00,1,1,16.31,53.75,45.36,44,94,138
2012-02-16 11:00:00,4,3,7.61,76.06,27.6,16,120,136
2012-02-16 12:00:00,1,4,19.09,71.81,34.64,13,181,194
2012-02-16 13:00:00,4,2,27.56,73.55,37.4,18,56,74
2012-02-16 14:00:00,1,4,15.81,90.4,10.19,17,32,49
2012-02-16 15:00:00,4,2,12.06,29.68,46.73,22,197,219
2012-02-16 16:00:00,3,1,32.94,61.77,26.34,7,191,198
2012-02-16 17:00:00,3,3,29.65,78.04,4.62,49,107,156
2012-02-16 18:00:00,3,1,24.15,70.89,19.85,15,131,146
2012-02-16 19:00:00,1,3,9.1,55.87,30.08,24,15,39
2012-02-16 20:00:00,3,3,9.35,21.37,17.64,42,130,172
2012-02-16 21:00:00,2,4,8.1,24.84,34.96,31,88,119
2012-02-16 22:00:00,3,2,23.49,29.52,44.1,48,190,238
2012-02-16 23:00:00,4,1,8.47,47.46,38.59,49,80,129
2012-02-17 00:00:00,4,1,30.28,29.41,32.13,18,149,167
2012-02-17 01:00:00,4,1,34.79,54.09,25.61,17,81,98
2012-02-17 02:00:00,1,4,15.99,34.29,12.72,31,95,126
2012-02-17 03:00:00,2,4,18.61,82.33,22.75,45,145,190
2012-02-17 04:00:00,3,4,26.35,89.72,14.65,48,56,104
2012-02-17 05:00:00,2,3,33.11,51.17,46.7,39,152,191
2012-02-17 06:00:00,2,1,31.82,60.91,45.37,14,27,41
2012-02-17 07:00:00,4,3,6.73,96.28,7.79,48,167,215
2012-02-17 08:00:00,4,1,10.07,62.84,41.13,20,150,170
2012-02-17 09:00:00,4,1,27.64,99.61,35.15,10,135,145
2012-02-17 10:00:00,1,2,25.67,31.37,48.76,28,140,168
2012-02-17 11:00:00,2,1,9.0,88.98,23.17,31,171,202
2012-02-17 12:00:00,2,4,20.06,59.78,36.11,5,120,125
2012-02-17 13:00:00,1,4,28.42,21.82,25.89,18,46,64
2012-02-17 14:00:00,1,4,11.56,97.78,3.47,15,9,24
2012-02-17 15:00:00,1,2,31.14,97.2,2.34,11,40,51
2012-02-17 16:00:00,2,2,6.59,50.66,6.11,14,194,208
2012-02-17 17:00:00,2,3,28.47,96.33,14.81,10,73,83
2012-02-17 18:00:00,4,1,23.47,31.28,12.96,38,176,214
2012-02-17 19:00:00,4,1,14.46,74.41,36.42,9,191,200
2012-02-17 20:00:00,2,4,26.63,35.35,35.8,36,14,50
2012-02-17 21:00:00,4,4,28.47,39.73,48.57,48,188,236
2012-02-17 22:00:00,1,4,33.02,82.35,15.52,23,73,96
2012-02-17 23:00:00,3,4,16.03,50.19,46.92,35,51,86
2012-02-18 00:00:00,4,4,25.58,20.57,30.64,0,173,173
2012-02-18 01:00:00,2,4,23.08,53.14,24.77,45,58,103
2012-02-18 02:00:00,4,1,20.76,38.25,33.39,16,175,191
2012-02-18 03:00:00,4,2,31.71,74.67,35.14,13,117,130
2012-02-18 04:00:00,4,4,5.1,35.56,8.6,37,38,75
2012-02-18 05:00:00,3,1,13.46,87.38,37.59,24,125,149
2012-02-18 06:00:00,1,4,21.15,41.37,36.26,36,41,77
2012-02-18 07:00:00,2,3,10.35,51.44,49.88,34,50,84
2012-02-18 08:00:00,3,3,32.24,43.84,45.6,21,49,70
2012-02-18 09:00:00,2,1,24.43,71.51,34.23,46,91,137
2012-02-18 10:00:00,2,2,19.34,28.09,35.62,6,104,110
2012-02-18 11:00:00,2,3,29.44,58.25,47.3,10,65,75
2012-02-18 12:00:00,3,3,18.53,46.76,48.36,9,168,177
2012-02-18 13:00:00,1,2,21.76,90.73,41.35,13,57,70
2012-02-18 14:00:00,2,3,5.08,25.87,38.37,34,126,160
2012-02-18 15:00:00,1,4,15.97,86.38,5.57,45,3,48
2012-02-18 16:00:00,1,2,9.16,33.41,41.52,48,176,224
2012-02-18 17:00:00,4,3,25.69,27.09,12.66,35,130,165
2012-02-18 18:00:00,3,2,19.37,36.19,28.19,5,31,36
2012-02-18 19:00:00,3,4,14.05,28.21,20.27,4,174,178
2012-02-18 20:00:00,4,3,19.03,61.68,17.28,41,61,102
2012-02-18 21:00:00,4,1,11.29,99.06,15.51,6,143,149
2012-02-18 22:00:00,1,3,32.75,22.75,42.77,14,195,209
2012-02-18 23:00:00,2,3,6.62,56.89,38.46,20,17,37
2012-02-19 00:00:00,3,4,30.96,50.89,26.17,17,133,150
2012-02-19 01:00:00,2,1,20.34,47.17,33.22,0,105,105
2012-02-19 02:00:00,2,1,23.57,46.55,49.23,3,64,67
2012-02-19 03:00:00,4,1,14.08,91.6,19.88,10,79,89
2012-02-19 04:00:00,2,4,34.0,21.52,27.56,9,36,45
2012-02-19 05:00:00,1,4,13.46,81.99,26.68,44,72,116
2012-02-19 06:00:00,4,4,22.67,40.23,46.8,18,190,208
2012-02-19 07:00:00,2,4,34.8,50.66,17.58,41,80,121
2012-02-19 08:00:00,4,4,31.43,53.61,49.31,29,99,128
2012-02-19 09:00:00,1,1,21.09,44.38,15.23,49,58,107
2012-02-19 10:00:00,1,2,34.71,27.48,5.45,40,94,134
2012-02-19 11:00:00,2,4,26.04,29.15,9.57,40,161,201
2012-02-19 12:00:00,4,2,11.26,43.85,21.31,19,36,55
2012-02-19 13:00:00,2,3,17.17,85.74,32.49,26,161,187
2012-02-19 14:00:00,2,3,15.03,30.77,25.84,11,172,183
2012-02-19 15:00:00,4,4,15.32,79.41,18.81,13,100,113
2012-02-19 16:00:00,2,3,27.81,43.11,28.1,33,128,161
2012-02-19 17:00:00,1,2,22.53,90.68,41.94,41,52,93
2012-02-19 18:00:00,4,3,6.14,54.27,41.95,49,61,110
2012-02-19 19:00:00,4,3,31.32,33.74,36.31,37,142,179
2012-02-19 20:00:00,4,2,13.9,98.87,47.62,1,50,51
2012-02-19 21:00:00,4,3,34.91,34.13,29.51,48,13,61
2012-02-19 22:00:00,2,4,33.63,65.41,0.38,31,107,138
2012-02-19 23:00:00,2,2,33.22,65.54,14.55,17,97,114
2012-02-20 00:00:00,1,2,29.33,49.83,16.41,49,58,107
2012-02-20 01:00:00,3,1,11.62,96.12,27.37,20,179,199
2012-02-20 02:00:00,3,1,20.98,87.51,45.24,45,0,45
2012-02-20 03:00:00,1,2,11.73,86.39,41.91,10,144,154
2012-02-20 04:00:00,3,2,12.79,97.93,11.61,29,55,84
2012-02-20 05:00:00,1,1,23.33,56.57,25.97,18,132,150
2012-02-20 06:00:00,2,4,6.23,27.77,32.96,47,144,191
2012-02-20 07:00:00,4,3,34.08,81.24,49.38,39,17,56
2012-02-20 08:00:00,4,3,32.56,50.47,1.57,49,88,137
2012-02-20 09:00:00,2,3,16.42,35.23,23.19,29,54,83
2012-02-20 10:00:00,4,2,20.46,58.66,49.41,34,46,80
2012-02-20 11:00:00,4,4,18.98,94.06,48.86,3,176,179
2012-02-20 12:00:00,3,1,31.47,33.71,16.54,20,150,170
2012-02-20 13:00:00,2,4,25.66,87.9,0.0,4,103,107
2012-02-20 14:00:00,3,4,13.34,53.46,29.34,35,20,55
2012-02-20 15:00:00,3,3,18.41,30.94,43.35,26,156,182
2012-02-20 16:00:00,4,1,17.87,87.87,16.21,6,187,193
2012-02-20 17:00:00,4,4,33.78,97.57,46.71,30,173,203
2012-02-20 18:00:00,2,1,10.26,43.3,16.64,19,99,118
2012-02-20 19:00:00,4,2,7.69,44.28,30.51,24,9,33
2012-02-20 20:00:00,4,3,31.42,51.24,36.1,37,83,120
2012-02-20 21:00:00,2,1,31.9,85.13,17.27,24,52,76
2012-02-20 22:00:00,4,2,31.15,20.83,17.61,16,126,142
2012-02-20 23:00:00,3,2,20.33,37.92,23.5,45,134,179
2012-02-21 00:00:00,2,2,24.79,76.47,41.76,36,29,65
2012-02-21 01:00:00,4,4,21.9,52.45,5.04,14,92,106
2012-02-21 02:00:00,1,4,7.08,46.42,31.57,9,54,63
2012-02-21 03:00:00,2,3,22.88,89.78,33.87,33,64,97
2012-02-21 04:00:00,2,3,5.41,93.39,27.89,43,20,63
2012-02-21 05:00:00,1,2,14.75,95.84,46.79,42,6,48
2012-02-21 06:00:00,4,3,32.97,41.8,30.1,6,43,49
2012-02-21 07:00:00,4,4,14.12,93.0,31.73,38,67,105
2012-02-21 08:00:00,2,3,33.19,78.96,29.99,24,102,126
2012-02-21 09:00:00,2,1,12.5,32.34,36.1,38,142,180
2012-02-21 10:00:00,4,4,14.44,68.82,6.77,45,97,142
2012-02-21 11:00:00,4,2,23.85,22.11,44.71,43,1,44
2012-02-21 12:00:00,3,2,27.85,76.67,2.12,27,100,127
2012-02-21 13:00:00,2,3,20.04,78.69,32.04,41,130,171
2012-02-21 14:00:00,2,4,31.46,83.15,30.77,26,175,201
2012-02-21 15:00:00,1,2,6.21,33.8,10.41,36,195,231
2012-02-21 16:00:00,3,2,32.67,70.26,2.04,38,46,84
2012-02-21 17:00:00,4,4,10.89,34.31,6.94,37,170,207
2012-02-21 18:00:00,3,4,31.53,95.73,13.58,27,99,126
2012-02-21 19:00:00,4,2,17.03,74.0,44.11,33,26,59
2012-02-21 20:00:00,4,3,29.98,27.63,42.79,28,131,159
2012-02-21 21:00:00,3,3,25.15,34.96,3.19,44,35,79
2012-02-21 22:00:00,2,3,10.28,73.08,14.46,47,82,129
2012-02-21 23:00:00,4,1,32.54,58.13,44.47,7,97,104
2012-02-22 00:00:00,3,4,12.37,78.9,11.83,12,79,91
2012-02-22 01:00:00,1,2,12.32,42.46,49.8,45,179,224
2012-02-22 02:00:00,3,1,29.43,72.63,12.84,36,172,208
2012-02-22 03:00:00,1,3,8.18,34.16,36.96,2,50,52
2012-02-22 04:00:00,4,1,11.66,63.5,20.85,13,85,98
2012-02-22 05:00:00,3,2,20.11,96.62,6.81,31,159,190
2012-02-22 06:00:00,3,2,29.91,70.26,12.76,22,1,23
2012-02-22 07:00:00,1,4,9.42,24.0,33.76,22,16,38
2012-02-22 08:00:00,3,3,21.43,99.1,16.85,12,22,34
2012-02-22 09:00:00,3,3,26.34,32.55,30.21,48,171,219
2012-02-22 10:00:00,4,1,30.82,77.45,10.28,40,45,85
2012-02-22 11:00:00,3,3,33.07,62.6,22.43,38,139,177
2012-02-22 12:00:00,2,1,28.54,43.55,25.61,49,53,102
2012-02-22 13:00:00,1,2,24.58,34.18,20.64,20,12,32
2012-02-22 14:00:00,3,2,18.01,34.22,9.9,42,195,237
2012-02-22 15:00:00,1,2,8.36,88.67,23.08,47,70,117
2012-02-22 16:00:00,1,2,26.29,89.83,34.65,30,193,223
2012-02-22 17:00:00,1,2,34.78,57.21,48.25,49,14,63
2012-02-22 18:00:00,3,1,27.1,28.29,39.48,6,61,67
2012-02-22 19:00:00,3,2,5.5,90.73,8.07,35,151,186
2012-02-22 20:00:00,1,1,19.89,58.96,13.64,18,69,87
2012-02-22 21:00:00,2,2,23.44,55.1,3.94,21,188,209
2012-02-22 22:00:00,1,1,25.69,52.59,6.78,23,70,93
2012-02-22 23:00:00,2,1,26.59,49.2,12.53,23,199,222
2012-02-23 00:00:00,1,1,21.74,62.08,9.98,20,130,150
2012-02-23 01:00:00,4,3,11.7,68.36,10.68,42,156,198
2012-02-23 02:00:00,1,1,33.27,57.31,11.54,12,20,32
2012-02-23 03:00:00,1,1,25.9,91.73,15.03,5,53,58
2012-02-23 04:00:00,3,2,12.11,45.41,6.28,27,133,160
2012-02-23 05:00:00,2,1,14.67,66.26,13.89,31,120,151
2012-02-23 06:00:00,4,1,32.66,44.0,34.42,12,10,22
2012-02-23 07:00:00,2,4,31.62,80.27,11.82,33,197,230
2012-02-23 08:00:00,4,3,17.15,28.17,8.59,31,154,185
2012-02-23 09:00:00,1,4,6.15,35.1,3.38,13,124,137
2012-02-23 10:00:00,3,2,6.45,84.1,25.0,31,187,218
2012-02-23 11:00:00,3,3,13.52,34.66,42.1,44,71,115
2012-02-23 12:00:00,2,3,23.87,70.06,2.95,4,108,112
2012-02-23 13:00:00,3,4,22.53,97.62,27.12,34,26,60
2012-02-23 14:00:00,2,3,24.01,61.83,32.53,3,159,162
2012-02-23 15:00:00,2,4,26.52,34.99,29.62,13,92,105
2012-02-23 16:00:00,4,1,5.57,45.66,43.88,17,32,49
2012-02-23 17:00:00,2,4,8.15,85.88,43.32,10,4,14
2012-02-23 18:00:00,4,3,15.78,48.13,2.87,18,8,26
2012-02-23 19:00:00,3,3,9.65,77.88,18.05,1,140,141
2012-02-23 20:00:00,2,2,7.26,82.19,33.54,33,93,126
2012-02-23 21:00:00,2,2,24.23,60.09,47.62,2,117,119
2012-02-23 22:00:00,1,2,29.46,82.66,40.23,28,88,116
2012-02-23 23:00:00,2,2,27.58,45.35,8.83,22,133,155
2012-02-24 00:00:00,2,3,29.51,61.29,13.96,47,102,149
2012-02-24 01:00:00,1,2,24.98,74.92,38.18,0,73,73
2012-02-24 02:00:00,1,4,27.06,33.45,23.57,41,163,204
2012-02-24 03:00:00,3,1,13.15,41.89,27.37,5,124,129
2012-02-24 04:00:00,2,3,34.79,72.16,30.45,16,177,193
2012-02-24 05:00:00,3,2,10.49,72.43,5.16,18,188,206
2012-02-24 06:00:00,3,3,11.43,59.46,42.8,43,47,90
2012-02-24 07:00:00,1,2,13.67,83.65,43.16,47,82,129
2012-02-24 08:00:00,4,3,34.26,58.56,23.41,1,10,11
2012-02-24 09:00:00,3,2,34.65,90.51,31.34,14,144,158
2012-02-24 10:00:00,4,1,28.85,78.87,33.0,22,129,151
2012-02-24 11:00:00,2,2,23.87,45.18,9.49,18,6,24
2012-02-24 12:00:00,1,4,20.6,51.62,5.63,32,104,136
2012-02-24 13:00:00,2,3,34.12,73.41,1.03,5,56,61
2012-02-24 14:00:00,2,3,25.87,91.56,45.64,49,30,79
2012-02-24 15:00:00,1,4,33.34,34.3,17.29,18,120,138
2012-02-24 16:00:00,2,4,14.5,61.17,4.29,29,186,215
2012-02-24 17:00:00,1,1,15.01,29.5,23.29,21,173,194
2012-02-24 18:00:00,4,3,30.64,42.36,3.78,2,80,82
2012-02-24 19:00:00,2,1,9.5,74.88,4.26,4,78,82
2012-02-24 20:00:00,1,3,33.38,26.22,24.44,29,134,163
2012-02-24 21:00:00,3,3,20.22,72.99,25.44,2,93,95
2012-02-24 22:00:00,2,1,32.79,92.06,29.01,38,141,179
2012-02-24 23:00:00,4,3,15.1,97.55,32.82,38,94,132
2012-02-25 00:00:00,1,3,26.48,37.33,33.41,27,8,35
2012-02-25 01:00:00,2,1,19.49,79.91,21.65,0,8,8
2012-02-25 02:00:00,2,2,23.8,94.11,32.18,21,112,133
2012-02-25 03:00:00,2,1,20.13,27.31,15.24,44,121,165
2012-02-25 04:00:00,4,3,34.01,53.12,22.07,44,129,173
2012-02-25 05:00:00,1,4,25.76,93.55,19.67,46,107,153
2012-02-25 06:00:00,3,2,12.54,36.22,16.46,38,85,123
2012-02-25 07:00:00,3,4,32.29,94.7,11.93,16,15,31
2012-02-25 08:00:00,3,2,13.82,62.18,3.92,41,1,42
2012-02-25 09:00:00,1,4,16.15,27.99,25.3,27,197,224
2012-02-25 10:00:00,3,2,8.06,55.99,26.86,49,150,199
2012-02-25 11:00:00,4,1,32.0,46.1,16.81,29,125,154
2012-02-25 12:00:00,1,2,13.58,42.58,48.79,39,117,156
2012-02-25 13:00:00,2,2,12.77,63.32,27.85,7,155,162
2012-02-25 14:00:00,4,2,32.61,58.69,44.45,26,127,153
2012-02-25 15:00:00,2,3,29.17,58.56,28.5,40,42,82
2012-02-25 16:00:00,3,4,9.23,27.05,9.5,44,62,106
2012-02-25 17:00:00,4,1,28.08,84.19,48.73,24,124,148
2012-02-25 18:00:00,1,4,32.39,58.52,44.27,12,144,156
2012-02-25 19:00:00,4,4,7.36,85.67,23.56,33,163,196
2012-02-25 20:00:00,2,1,29.76,85.97,12.15,38,18,56
2012-02-25 21:00:00,1,3,21.42,45.37,11.13,6,132,138
2012-02-25 22:00:00,4,2,25.08,20.35,40.3,21,22,43
2012-02-25 23:00:00,4,3,19.79,92.9,3.46,32,107,139
2012-02-26 00:00:00,4,3,25.93,80.86,31.9,45,18,63
2012-02-26 01:00:00,4,2,6.02,28.58,32.01,37,127,164
2012-02-26 02:00:00,1,4,27.88,76.14,9.12,30,128,158
2012-02-26 03:00:00,2,2,6.0,21.6,35.25,44,154,198
2012-02-26 04:00:00,4,1,18.66,22.22,35.27,32,42,74
2012-02-26 05:00:00,1,2,9.53,62.07,17.5,21,24,45
2012-02-26 06:00:00,2,4,29.71,27.68,24.17,26,181,207
2012-02-26 07:00:00,4,3,14.41,97.15,41.64,26,5,31
2012-02-26 08:00:00,2,3,18.62,91.51,26.16,20,80,100
2012-02-26 09:00:00,2,2,17.86,71.98,30.91,34,75,109
2012-02-26 10:00:00,1,1,28.18,25.1,20.64,46,24,70
2012-02-26 11:00:00,2,4,19.43,45.99,7.48,49,118,167
2012-02-26 12:00:00,1,3,28.67,49.74,49.9,9,121,130
2012-02-26 13:00:00,4,2,7.21,58.47,26.58,46,173,219
2012-02-26 14:00:00,2,1,10.75,33.51,16.82,27,102,129
2012-02-26 15:00:00,2,1,21.55,66.2,35.69,39,58,97
2012-02-26 16:00:00,3,3,33.41,54.86,31.04,36,118,154
2012-02-26 17:00:00,4,3,7.24,95.78,11.65,40,54,94
2012-02-26 18:00:00,4,4,6.29,94.9,43.85,32,151,183
2012-02-26 19:00:00,3,1,9.7,65.24,3.55,7,74,81
2012-02-26 20:00:00,3,4,24.23,71.55,30.28,36,151,187
2012-02-26 21:00:00,1,1,16.97,31.02,23.89,49,130,179
2012-02-26 22:00:00,1,1,29.77,37.87,15.91,40,167,207
2012-02-26 23:00:00,2,2,7.16,92.06,41.32,32,147,179
2012-02-27 00:00:00,2,3,10.89,75.93,32.81,18,86,104
2012-02-27 01:00:00,2,1,14.0,35.15,37.97,29,196,225
2012-02-27 02:00:00,2,4,23.8,65.62,20.73,13,123,136
2012-02-27 03:00:00,1,3,25.56,94.78,47.12,13,76,89
2012-02-27 04:00:00,4,4,8.73,47.61,17.24,35,197,232
2012-02-27 05:00:00,2,3,33.31,34.87,26.55,6,193,199
2012-02-27 06:00:00,4,3,15.23,95.36,46.68,42,92,134
2012-02-27 07:00:00,2,1,26.4,56.9,4.16,33,196,229
2012-02-27 08:00:00,3,2,20.73,53.38,5.44,49,78,127
2012-02-27 09:00:00,2,1,11.68,41.41,49.71,31,7,38
2012-02-27 10:00:00,2,3,30.39,91.33,48.57,41,97,138
2012-02-27 11:00:00,2,1,29.55,87.65,38.59,32,116,148
2012-02-27 12:00:00,1,1,16.88,52.24,24.21,13,54,67
2012-02-27 13:00:00,3,3,22.66,22.45,25.3,24,36,60
2012-02-27 14:00:00,2,3,12.73,55.73,12.86,27,89,116
2012-02-27 15:00:00,2,1,25.7,34.47,21.64,41,199,240
2012-02-27 16:00:00,4,1,14.27,31.42,21.57,49,13,62
2012-02-27 17:00:00,3,1,30.32,51.45,1.8,38,175,213
2012-02-27 18:00:00,2,4,11.52,27.93,22.66,29,88,117
2012-02-27 19:00:00,4,1,5.44,96.6,23.99,30,66,96
2012-02-27 20:00:00,4,4,13.06,23.8,33.29,23,159,182
2012-02-27 21:00:00,1,2,10.73,52.11,25.82,3,163,166
2012-02-27 22:00:00,4,4,20.25,33.02,43.08,13,132,145
2012-02-27 23:00:00,2,1,11.11,75.1,18.38,8,78,86
2012-02-28 00:00:00,1,2,27.9,26.3,20.49,35,121,156
2012-02-28 01:00:00,1,4,12.24,63.74,28.57,5,17,22
2012-02-28 02:00:00,2,4,26.21,81.85,10.14,23,10,33
2012-02-28 03:00:00,3,3,22.35,96.0,19.67,25,73,98
2012-02-28 04:00:00,4,2,34.59,75.88,34.31,33,131,164
2012-02-28 05:00:00,1,3,35.0,27.96,20.59,0,125,125
2012-02-28 06:00:00,3,2,31.09,27.08,45.33,22,147,169
2012-02-28 07:00:00,2,4,27.8,78.53,30.77,16,132,148
2012-02-28 08:00:00,4,3,16.59,37.23,7.69,35,190,225
2012-02-28 09:00:00,4,1,27.6,55.78,24.37,36,181,217
2012-02-28 10:00:00,1,4,33.7,98.13,38.24,49,192,241
2012-02-28 11:00:00,4,2,5.7,85.59,32.17,44,109,153
2012-02-28 12:00:00,4,2,21.14,87.73,44.26,19,140,159
2012-02-28 13:00:00,4,3,11.54,88.86,37.5,25,72,97
2012-02-28 14:00:00,4,3,21.74,69.56,3.08,10,2,12
2012-02-28 15:00:00,2,2,18.99,79.51,5.63,19,1,20
2012-02-28 16:00:00,3,4,22.27,48.72,32.49,0,139,139
2012-02-28 17:00:00,2,3,21.53,99.88,11.92,43,87,130
2012-02-28 18:00:00,2,1,33.8,42.37,29.39,12,55,67
2012-02-28 19:00:00,1,2,21.57,67.2,39.61,35,57,92
2012-02-28 20:00:00,4,1,30.39,42.56,28.85,43,179,222
2012-02-28 21:00:00,2,2,14.59,28.97,20.77,37,142,179
2012-02-28 22:00:00,4,1,18.14,65.41,32.31,12,0,12
2012-02-28 23:00:00,2,4,19.11,48.27,7.18,13,199,212
2012-02-29 00:00:00,2,2,13.36,66.66,36.16,11,112,123
2012-02-29 01:00:00,1,4,16.39,64.69,34.85,33,70,103
2012-02-29 02:00:00,3,3,22.96,63.38,25.72,26,101,127
2012-02-29 03:00:00,3,2,22.41,29.86,13.94,11,44,55
2012-02-29 04:00:00,2,4,24.09,55.21,39.88,37,143,180
2012-02-29 05:00:00,1,1,15.55,84.96,25.53,35,122,157
2012-02-29 06:00:00,4,4,14.47,45.21,2.96,0,16,16
2012-02-29 07:00:00,4,2,23.35,55.51,45.93,25,29,54
2012-02-29 08:00:00,2,4,8.99,59.51,38.39,39,36,75
2012-02-29 09:00:00,3,1,12.59,89.02,29.24,39,17,56
2012-02-29 10:00:00,1,1,6.26,72.45,21.84,20,10,30
2012-02-29 11:00:00,3,1,7.18,28.02,47.99,31,59,90
2012-02-29 12:00:00,4,3,12.3,89.21,38.75,24,186,210
2012-02-29 13:00:00,3,2,5.59,86.57,26.75,11,197,208
2012-02-29 14:00:00,4,1,12.36,80.29,32.66,24,153,177
2012-02-29 15:00:00,1,3,24.65,57.28,14.04,25,79,104
2012-02-29 16:00:00,1,1,6.83,80.6,9.79,35,37,72
2012-02-29 17:00:00,2,4,18.1,58.3,13.67,15,136,151
2012-02-29 18:00:00,2,2,32.39,78.93,14.66,13,45,58
2012-02-29 19:00:00,3,4,28.74,90.41,36.99,45,171,216
2012-02-29 20:00:00,1,3,14.16,91.24,7.0,33,41,74
2012-02-29 21:00:00,1,4,32.74,56.37,38.88,48,196,244
2012-02-29 22:00:00,2,4,14.89,88.75,26.17,23,22,45
2012-02-29 23:00:00,4,1,7.18,28.12,19.23,7,105,112
2012-03-01 00:00:00,3,4,34.82,28.15,15.02,26,33,59
2012-03-01 01:00:00,3,1,31.1,63.86,25.66,38,149,187
2012-03-01 02:00:00,2,1,18.98,72.15,15.88,12,196,208
2012-03-01 03:00:00,1,2,24.99,32.24,21.47,28,192,220
2012-03-01 04:00:00,2,3,25.14,57.77,36.95,30,153,183
2012-03-01 05:00:00,2,3,10.83,27.55,31.3,42,54,96
2012-03-01 06:00:00,2,3,11.0,68.17,37.4,18,14,32
2012-03-01 07:00:00,2,1,19.09,88.41,35.65,9,193,202
2012-03-01 08:00:00,4,3,32.35,79.01,40.75,42,180,222
2012-03-01 09:00:00,4,1,5.3,50.26,10.08,47,78,125
2012-03-01 10:00:00,1,2,28.48,99.5,49.76,39,10,49
2012-03-01 11:00:00,2,3,6.73,73.03,23.79,33,57,90
2012-03-01 12:00:00,4,1,19.35,85.22,35.91,45,41,86
2012-03-01 13:00:00,1,3,24.14,73.58,33.89,48,80,128
2012-03-01 14:00:00,2,3,25.6,99.15,28.31,48,196,244
2012-03-01 15:00:00,3,2,6.75,85.71,49.79,42,160,202
2012-03-01 16:00:00,4,4,17.56,61.55,10.87,0,171,171
2012-03-01 17:00:00,1,3,22.52,49.35,21.09,18,88,106
2012-03-01 18:00:00,3,2,6.98,74.57,6.39,0,134,134
2012-03-01 19:00:00,2,3,9.05,67.22,9.09,23,116,139
2012-03-01 20:00:00,2,3,24.91,70.35,35.65,24,51,75
2012-03-01 21:00:00,2,3,20.65,47.44,0.24,3,12,15
2012-03-01 22:00:00,4,3,9.85,54.3,44.49,23,31,54
2012-03-01 23:00:00,1,4,21.06,64.65,31.66,38,38,76
2012-03-02 00:00:00,3,4,32.38,87.14,22.05,19,77,96
2012-03-02 01:00:00,1,3,5.47,81.03,16.57,32,62,94
2012-03-02 02:00:00,4,3,24.28,29.49,6.31,27,19,46
2012-03-02 03:00:00,1,2,7.21,39.64,46.08,42,15,57
2012-03-02 04:00:00,4,2,5.19,22.13,35.62,44,157,201
2012-03-02 05:00:00,2,1,9.52,20.64,16.82,34,104,138
2012-03-02 06:00:00,3,4,17.69,37.95,3.55,23,146,169
2012-03-02 07:00:00,2,3,29.07,83.95,16.28,39,100,139
2012-03-02 08:00:00,1,4,13.45,92.38,9.23,43,73,116
2012-03-02 09:00:00,2,2,23.77,51.34,39.31,1,71,72
2012-03-02 10:00:00,3,4,17.33,65.06,35.98,22,77,99
2012-03-02 11:00:00,2,4,12.03,76.48,24.91,32,157,189
2012-03-02 12:00:00,3,3,20.43,96.23,44.29,13,105,118
2012-03-02 13:00:00,3,3,28.92,93.03,9.03,14,161,175
2012-03-02 14:00:00,2,2,29.97,24.58,22.6,31,166,197
2012-03-02 15:00:00,4,3,30.4,39.85,35.53,22,48,70
2012-03-02 16:00:00,1,2,15.16,23.93,3.39,3,100,103
2012-03-02 17:00:00,4,2,28.8,69.32,18.63,19,119,138
2012-03-02 18:00:00,4,1,11.37,76.84,28.58,30,132,162
2012-03-02 19:00:00,2,1,27.15,44.66,18.34,6,104,110
2012-03-02 20:00:00,1,1,33.45,88.31,24.01,0,42,42
2012-03-02 21:00:00,1,4,5.41,56.23,30.41,4,46,50
2012-03-02 22:00:00,4,1,18.21,99.87,18.42,13,186,199
2012-03-02 23:00:00,2,3,24.43,20.03,5.3,29,196,225
2012-03-03 00:00:00,1,3,26.05,28.76,6.97,37,144,181
2012-03-03 01:00:00,4,1,10.28,44.14,26.35,22,18,40
2012-03-03 02:00:00,1,4,34.17,22.04,8.74,6,173,179
2012-03-03 03:00:00,2,2,23.46,82.59,44.49,43,116,159
2012-03-03 04:00:00,2,4,9.93,24.22,41.71,38,55,93
2012-03-03 05:00:00,2,4,5.62,79.92,17.45,49,153,202
2012-03-03 06:00:00,1,2,28.5,24.21,41.55,15,193,208
2012-03-03 07:00:00,3,2,7.39,40.22,26.66,8,141,149
2012-03-03 08:00:00,1,2,9.23,87.3,7.95,38,179,217
2012-03-03 09:00:00,3,3,22.24,96.09,30.71,45,91,136
2012-03-03 10:00:00,2,2,23.11,53.16,33.97,33,131,164
2012-03-03 11:00:00,4,2,25.61,97.6,4.19,30,130,160
2012-03-03 12:00:00,3,4,16.81,70.15,15.72,44,78,122
2012-03-03 13:00:00,2,4,28.22,53.27,0.27,6,149,155
2012-03-03 14:00:00,2,1,34.23,84.22,15.82,1,111,112
2012-03-03 15:00:00,3,4,13.13,43.63,16.77,5,49,54
2012-03-03 16:00:00,4,2,26.09,41.26,31.51,43,191,234
2012-03-03 17:00:00,2,3,32.85,72.52,9.95,33,9,42
2012-03-03 18:00:00,3,4,25.59,51.24,1.5,16,183,199
2012-03-03 19:00:00,4,4,25.43,30.87,15.78,25,97,122
2012-03-03 20:00:00,4,2,11.71,25.36,41.28,11,15,26
2012-03-03 21:00:00,2,4,21.05,83.03,19.96,19,36,55
2012-03-03 22:00:00,1,4,21.88,74.07,20.75,40,99,139
2012-03-03 23:00:00,1,2,26.0,52.94,23.45,45,182,227
2012-03-04 00:00:00,2,4,34.9,91.7,37.59,34,21,55
2012-03-04 01:00:00,4,3,6.01,52.87,24.0,34,121,155
2012-03-04 02:00:00,2,1,6.96,76.82,4.56,28,31,59
2012-03-04 03:00:00,3,4,7.34,92.73,10.32,47,171,218
2012-03-04 04:00:00,1,3,27.29,87.26,9.39,37,80,117
2012-03-04 05:00:00,3,4,9.09,60.89,25.39,30,72,102
2012-03-04 06:00:00,2,1,23.67,74.45,1.5,39,179,218
2012-03-04 07:00:00,2,2,14.74,53.09,14.18,12,32,44
2012-03-04 08:00:00,4,1,18.72,71.78,30.36,25,119,144
2012-03-04 09:00:00,4,4,11.47,40.6,17.73,21,96,117
2012-03-04 10:00:00,4,1,30.98,54.78,35.39,7,129,136
2012-03-04 11:00:00,3,1,22.58,36.76,19.56,39,13,52
2012-03-04 12:00:00,4,2,33.34,23.05,48.96,6,100,106
2012-03-04 13:00:00,2,4,22.24,67.08,48.27,4,60,64
2012-03-04 14:00:00,4,1,8.72,89.15,39.99,0,64,64
2012-03-04 15:00:00,1,1,10.13,22.05,47.72,44,85,129
2012-03-04 16:00:00,4,2,34.67,35.68,10.24,39,29,68
2012-03-04 17:00:00,3,3,26.77,56.81,37.55,10,26,36
2012-03-04 18:00:00,1,4,6.48,73.27,16.08,31,63,94
2012-03-04 19:00:00,1,3,26.11,33.7,36.26,6,32,38
2012-03-04 20:00:00,1,3,17.37,24.54,18.69,28,52,80
2012-03-04 21:00:00,3,2,14.22,61.52,14.47,29,79,108
2012-03-04 22:00:00,2,2,9.62,85.5,47.94,20,137,157
2012-03-04 23:00:00,4,4,30.2,22.82,10.49,38,154,192
2012-03-05 00:00:00,1,3,6.92,47.95,37.93,47,164,211
2012-03-05 01:00:00,1,1,13.7,73.08,33.73,43,129,172
2012-03-05 02:00:00,1,3,14.19,30.46,15.17,42,93,135
2012-03-05 03:00:00,2,2,9.83,38.88,22.92,40,109,149
2012-03-05 04:00:00,2,1,20.25,62.84,7.15,38,42,80
2012-03-05 05:00:00,3,1,5.35,96.26,46.06,19,146,165
2012-03-05 06:00:00,2,2,14.03,42.99,48.41,21,114,135
2012-03-05 07:00:00,4,1,33.01,59.0,36.62,28,98,126
2012-03-05 08:00:00,3,3,14.32,51.99,42.47,45,10,55
2012-03-05 09:00:00,3,2,15.81,91.79,4.13,3,51,54
2012-03-05 10:00:00,4,4,19.19,25.75,19.2,2,125,127
2012-03-05 11:00:00,4,2,21.85,65.29,16.54,8,121,129
2012-03-05 12:00:00,4,4,29.26,87.69,28.25,4,31,35
2012-03-05 13:00:00,3,4,10.71,99.05,9.17,2,79,81
2012-03-05 14:00:00,3,2,31.15,75.9,28.17,24,28,52
2012-03-05 15:00:00,3,2,27.73,50.39,32.72,31,35,66
2012-03-05 16:00:00,4,4,26.68,52.95,6.62,32,174,206
2012-03-05 17:00:00,4,4,7.6,48.13,6.59,17,87,104
2012-03-05 18:00:00,1,1,5.65,68.29,1.77,44,170,214
2012-03-05 19:00:00,2,2,22.82,79.15,38.04,35,111,146
2012-03-05 20:00:00,1,2,30.89,85.56,16.55,49,51,100
2012-03-05 21:00:00,4,1,22.53,53.33,11.27,40,52,92
2012-03-05 22:00:00,3,2,11.4,77.34,38.9,28,67,95
2012-03-05 23:00:00,4,1,7.72,93.3,7.16,38,132,170
2012-03-06 00:00:00,2,1,25.99,93.67,21.36,46,82,128
2012-03-06 01:00:00,1,2,26.65,76.32,37.24,44,175,219
2012-03-06 02:00:00,1,3,10.18,70.95,28.69,1,114,115
2012-03-06 03:00:00,3,4,5.85,62.52,27.7,10,151,161
2012-03-06 04:00:00,1,2,17.25,34.66,7.87,30,123,153
2012-03-06 05:00:00,1,3,22.48,29.89,9.05,3,125,128
2012-03-06 06:00:00,4,1,26.18,58.86,29.13,28,111,139
2012-03-06 07:00:00,1,3,29.3,32.76,1.18,49,0,49
2012-03-06 08:00:00,1,2,23.32,66.16,43.46,2,98,100
2012-03-06 09:00:00,1,2,8.33,71.66,17.52,1,1,2
2012-03-06 10:00:00,3,3,25.48,62.05,20.83,43,137,180
2012-03-06 11:00:00,3,2,34.53,22.91,12.92,35,190,225
2012-03-06 12:00:00,4,4,32.17,24.62,43.83,13,58,71
2012-03-06 13:00:00,1,3,31.15,29.07,32.13,47,5,52
2012-03-06 14:00:00,3,1,14.07,32.29,22.5,3,103,106
2012-03-06 15:00:00,3,3,27.52,99.19,29.27,43,82,125
2012-03-06 16:00:00,4,3,30.53,47.56,19.02,29,175,204
2012-03-06 17:00:00,2,3,25.35,43.36,23.28,18,163,181
2012-03-06 18:00:00,1,3,12.52,24.18,17.88,18,47,65
2012-03-06 19:00:00,3,1,33.62,70.83,20.53,43,156,199
2012-03-06 20:00:00,4,1,18.52,72.18,15.75,30,119,149
2012-03-06 21:00:00,4,1,8.89,34.04,3.88,14,168,182
2012-03-06 22:00:00,4,3,8.29,93.54,1.87,28,87,115
2012-03-06 23:00:00,3,4,24.43,84.04,8.71,2,127,129
2012-03-07 00:00:00,1,4,18.13,38.43,12.58,18,72,90
2012-03-07 01:00:00,2,1,7.83,58.87,44.52,21,31,52
2012-03-07 02:00:00,1,4,27.21,56.67,30.56,46,103,149
2012-03-07 03:00:00,4,4,28.98,47.88,47.91,19,4,23
2012-03-07 04:00:00,4,4,26.76,85.41,16.98,6,84,90
2012-03-07 05:00:00,2,4,11.07,28.74,20.09,3,16,19
2012-03-07 06:00:00,1,4,25.69,53.23,35.99,0,23,23
2012-03-07 07:00:00,4,2,5.32,54.24,28.9,40,127,167
2012-03-07 08:00:00,4,1,14.15,57.5,26.39,6,90,96
2012-03-07 09:00:00,1,3,16.96,88.91,28.78,21,111,132
2012-03-07 10:00:00,4,4,30.06,37.45,29.21,36,81,117
2012-03-07 11:00:00,1,2,16.71,28.23,38.29,29,85,114
2012-03-07 12:00:00,4,3,5.34,69.42,33.4,8,5,13
2012-03-07 13:00:00,1,2,15.57,33.91,47.87,26,27,53
2012-03-07 14:00:00,2,4,19.97,25.99,47.4,37,105,142
2012-03-07 15:00:00,4,4,33.47,54.13,21.1,22,147,169
2012-03-07 16:00:00,2,4,33.23,37.57,1.79,11,120,131
2012-03-07 17:00:00,4,4,10.43,48.9,0.55,12,146,158
2012-03-07 18:00:00,4,3,10.55,40.78,6.16,32,7,39
2012-03-07 19:00:00,3,3,9.9,27.41,3.74,14,17,31
2012-03-07 20:00:00,1,2,28.67,64.83,18.67,15,36,51
2012-03-07 21:00:00,2,1,5.18,22.16,2.64,33,188,221
2012-03-07 22:00:00,2,4,8.82,97.31,31.25,8,172,180
2012-03-07 23:00:00,2,2,21.14,47.31,9.51,41,37,78
2012-03-08 00:00:00,1,2,12.43,75.61,25.7,26,1,27
2012-03-08 01:00:00,3,2,7.77,84.83,5.15,47,182,229
2012-03-08 02:00:00,2,4,15.8,42.33,41.39,14,142,156
2012-03-08 03:00:00,1,4,13.23,79.9,39.0,34,58,92
2012-03-08 04:00:00,4,2,20.33,86.59,19.32,33,74,107
2012-03-08 05:00:00,2,4,34.38,39.31,45.53,39,132,171
2012-03-08 06:00:00,2,2,8.73,99.4,9.29,29,105,134
2012-03-08 07:00:00,3,3,16.18,21.66,40.7,47,147,194
2012-03-08 08:00:00,2,4,32.96,37.36,27.29,22,81,103
2012-03-08 09:00:00,2,3,31.31,82.4,16.48,8,139,147
2012-03-08 10:00:00,4,1,16.83,35.53,4.22,31,184,215
2012-03-08 11:00:00,1,4,25.97,75.86,8.57,34,112,146
2012-03-08 12:00:00,1,1,7.64,88.44,43.14,48,80,128
2012-03-08 13:00:00,3,2,26.38,96.74,30.34,31,67,98
2012-03-08 14:00:00,4,4,34.19,57.94,11.85,44,18,62
2012-03-08 15:00:00,1,4,21.12,97.69,24.79,15,86,101
2012-03-08 16:00:00,4,4,19.95,52.93,5.39,31,26,57
2012-03-08 17:00:00,1,1,10.62,37.45,4.94,24,115,139
2012-03-08 18:00:00,4,1,24.01,61.11,45.39,29,180,209
2012-03-08 19:00:00,3,2,22.71,71.99,22.89,36,169,205
2012-03-08 20:00:00,2,3,24.56,56.64,18.08,36,115,151
2012-03-08 21:00:00,3,3,5.78,65.36,47.45,34,44,78
2012-03-08 22:00:00,1,1,21.46,53.31,19.95,44,77,121
2012-03-08 23:00:00,3,4,22.85,61.98,16.81,7,67,74
2012-03-09 00:00:00,2,3,11.23,96.21,13.65,39,195,234
2012-03-09 01:00:00,3,3,11.25,59.99,28.25,48,151,199
2012-03-09 02:00:00,1,1,13.29,40.25,27.92,46,86,132
2012-03-09 03:00:00,1,2,26.35,80.7,0.81,35,35,70
2012-03-09 04:00:00,3,1,23.19,47.01,32.7,24,132,156
2012-03-09 05:00:00,2,1,30.37,85.3,39.42,17,26,43
2012-03-09 06:00:00,3,4,13.87,24.55,30.8,38,164,202
2012-03-09 07:00:00,2,1,32.36,46.57,43.49,9,26,35
2012-03-09 08:00:00,4,4,27.31,27.55,13.82,0,94,94
2012-03-09 09:00:00,2,2,16.85,26.83,9.6,3,75,78
2012-03-09 10:00:00,4,4,7.86,72.67,34.86,25,174,199
2012-03-09 11:00:00,3,2,12.71,50.83,9.43,10,191,201
2012-03-09 12:00:00,2,2,33.7,89.72,4.56,14,133,147
2012-03-09 13:00:00,4,2,14.31,61.31,4.83,31,75,106
2012-03-09 14:00:00,4,1,14.9,43.63,38.42,14,183,197
2012-03-09 15:00:00,4,4,10.69,77.67,1.44,27,127,154
2012-03-09 16:00:00,1,3,29.21,69.92,14.47,22,141,163
2012-03-09 17:00:00,3,1,13.27,83.97,6.46,2,21,23
2012-03-09 18:00:00,4,2,14.91,71.49,37.75,31,182,213
2012-03-09 19:00:00,2,3,17.43,33.36,25.17,19,74,93
2012-03-09 20:00:00,4,1,18.01,73.62,10.27,13,103,116
2012-03-09 21:00:00,1,3,17.34,51.32,37.52,34,51,85
2012-03-09 22:00:00,3,2,20.11,57.05,37.52,39,102,141
2012-03-09 23:00:00,1,3,29.44,93.73,26.15,41,183,224
2012-03-10 00:00:00,1,3,29.58,48.8,13.79,8,101,109
2012-03-10 01:00:00,1,2,28.95,68.96,29.31,46,120,166
2012-03-10 02:00:00,2,3,8.03,49.08,46.68,23,76,99
2012-03-10 03:00:00,3,1,28.99,27.58,2.58,40,5,45
2012-03-10 04:00:00,3,3,8.61,56.28,13.35,3,147,150
2012-03-10 05:00:00,2,4,8.74,67.76,14.25,11,53,64
2012-03-10 06:00:00,3,1,33.44,52.6,31.59,23,1,24
2012-03-10 07:00:00,1,3,29.58,51.25,32.56,0,71,71
2012-03-10 08:00:00,3,4,21.57,85.63,10.32,13,157,170
2012-03-10 09:00:00,2,4,31.25,22.37,10.81,30,90,120
2012-03-10 10:00:00,1,4,34.68,43.65,46.41,9,127,136
2012-03-10 11:00:00,2,3,23.32,84.94,37.81,32,181,213
2012-03-10 12:00:00,4,2,23.39,93.64,46.71,35,131,166
2012-03-10 13:00:00,1,4,27.63,52.98,41.48,41,198,239
2012-03-10 14:00:00,1,2,11.96,91.1,20.11,34,174,208
2012-03-10 15:00:00,3,1,10.01,35.91,6.1,47,87,134
2012-03-10 16:00:00,1,2,27.79,37.71,31.48,17,95,112
2012-03-10 17:00:00,2,2,15.35,87.7,17.6,24,146,170
2012-03-10 18:00:00,3,2,9.05,92.26,21.27,11,41,52
2012-03-10 19:00:00,4,2,14.45,37.82,21.29,27,98,125
2012-03-10 20:00:00,2,2,15.76,24.75,46.83,8,169,177
2012-03-10 21:00:00,4,1,33.96,27.23,3.44,23,50,73
2012-03-10 22:00:00,4,1,25.94,40.91,9.66,19,2,21
2012-03-10 23:00:00,4,2,20.93,80.92,30.4,25,36,61
2012-03-11 00:00:00,1,2,34.07,60.8,44.19,4,21,25
2012-03-11 01:00:00,2,4,32.09,56.45,45.9,26,160,186
2012-03-11 02:00:00,2,1,20.36,66.73,27.93,27,102,129
2012-03-11 03:00:00,1,3,32.17,91.22,1.73,36,97,133
2012-03-11 04:00:00,3,1,17.13,27.23,18.14,39,176,215
2012-03-11 05:00:00,4,3,11.91,75.58,45.94,6,86,92
2012-03-11 06:00:00,2,4,11.98,94.14,25.0,18,181,199
2012-03-11 07:00:00,1,2,24.87,37.07,36.33,21,61,82
2012-03-11 08:00:00,4,4,20.03,87.02,13.46,17,34,51
2012-03-11 09:00:00,3,2,24.77,75.84,1.25,14,28,42
2012-03-11 10:00:00,3,1,25.58,21.16,28.92,32,65,97
2012-03-11 11:00:00,4,2,5.67,38.53,41.75,38,124,162
2012-03-11 12:00:00,3,3,6.62,68.47,49.51,4,49,53
2012-03-11 13:00:00,2,3,20.98,60.19,42.33,39,13,52
2012-03-11 14:00:00,2,4,10.73,62.23,27.7,36,47,83
2012-03-11 15:00:00,2,1,23.98,38.55,30.44,4,43,47
2012-03-11 16:00:00,3,3,21.57,74.0,41.21,36,71,107
2012-03-11 17:00:00,2,4,22.57,41.31,0.99,42,128,170
2012-03-11 18:00:00,1,1,14.07,51.15,47.58,6,155,161
2012-03-11 19:00:00,2,1,24.2,49.51,26.56,1,2,3
2012-03-11 20:00:00,2,4,29.88,73.76,47.6,29,117,146
2012-03-11 21:00:00,3,3,34.94,27.22,38.23,48,198,246
2012-03-11 22:00:00,2,3,30.15,36.44,7.62,10,97,107
2012-03-11 23:00:00,4,4,21.72,36.04,8.26,36,47,83
2012-03-12 00:00:00,1,3,10.8,28.67,17.68,38,125,163
2012-03-12 01:00:00,3,4,25.44,36.61,13.2,32,159,191
2012-03-12 02:00:00,1,3,33.13,68.56,21.96,8,8,16
2012-03-12 03:00:00,4,3,11.36,78.57,30.2,10,184,194
2012-03-12 04:00:00,3,4,12.68,72.82,21.83,11,45,56
2012-03-12 05:00:00,3,4,9.47,58.02,2.82,9,57,66
2012-03-12 06:00:00,2,3,27.1,24.19,48.78,10,183,193
2012-03-12 07:00:00,1,4,17.2,96.72,21.26,32,14,46
2012-03-12 08:00:00,4,3,6.88,33.45,42.55,19,118,137
2012-03-12 09:00:00,4,2,31.25,73.47,3.7,4,188,192
2012-03-12 10:00:00,3,1,21.73,93.03,40.5,46,143,189
2012-03-12 11:00:00,2,1,14.93,75.82,8.67,23,114,137
2012-03-12 12:00:00,3,3,15.32,37.44,33.97,31,45,76
2012-03-12 13:00:00,3,1,13.71,45.26,33.09,30,70,100
2012-03-12 14:00:00,3,3,18.66,22.42,45.49,41,34,75
2012-03-12 15:00:00,3,4,15.11,69.02,16.03,43,65,108
2012-03-12 16:00:00,4,2,21.44,69.04,5.45,13,56,69
2012-03-12 17:00:00,4,1,28.21,78.04,43.23,18,111,129
2012-03-12 18:00:00,3,1,25.23,20.88,16.58,41,33,74
2012-03-12 19:00:00,3,4,13.83,85.43,11.63,23,30,53
2012-03-12 20:00:00,2,2,20.86,79.1,24.31,31,11,42
2012-03-12 21:00:00,3,2,30.2,31.27,7.31,11,192,203
2012-03-12 22:00:00,4,2,7.05,47.81,14.85,49,174,223
2012-03-12 23:00:00,1,4,7.35,71.08,19.26,20,64,84
2012-03-13 00:00:00,4,1,21.69,59.66,13.86,35,128,163
2012-03-13 01:00:00,2,1,24.17,29.21,22.51,24,78,102
2012-03-13 02:00:00,4,2,11.34,26.99,19.23,13,194,207
2012-03-13 03:00:00,1,4,27.36,82.52,38.73,7,13,20
2012-03-13 04:00:00,3,4,24.39,32.48,45.92,28,181,209
2012-03-13 05:00:00,1,4,32.7,33.77,5.05,24,137,161
2012-03-13 06:00:00,3,2,10.07,86.47,41.17,22,66,88
2012-03-13 07:00:00,3,4,27.54,68.97,46.59,35,83,118
2012-03-13 08:00:00,4,2,7.51,68.38,34.33,47,127,174
2012-03-13 09:00:00,4,2,21.96,58.35,49.82,11,49,60
2012-03-13 10:00:00,4,2,21.56,65.52,16.75,49,118,167
2012-03-13 11:00:00,2,3,16.65,68.14,41.52,11,127,138
2012-03-13 12:00:00,4,2,30.34,97.43,33.69,17,99,116
2012-03-13 13:00:00,2,4,5.13,37.84,16.17,35,90,125
2012-03-13 14:00:00,4,3,20.61,37.16,35.23,47,115,162
2012-03-13 15:00:00,3,1,11.51,24.58,25.48,49,163,212
2012-03-13 16:00:00,2,1,27.3,72.66,9.45,18,10,28
2012-03-13 17:00:00,1,4,6.29,63.92,8.69,47,130,177
2012-03-13 18:00:00,2,4,29.95,28.9,35.67,34,166,200
2012-03-13 19:00:00,2,4,30.14,49.16,35.6,48,9,57
2012-03-13 20:00:00,1,4,29.99,34.29,26.54,26,50,76
2012-03-13 21:00:00,2,3,9.58,46.52,25.07,2,31,33
2012-03-13 22:00:00,3,4,23.91,96.1,9.0,12,179,191
2012-03-13 23:00:00,4,2,5.43,74.67,21.46,37,71,108
2012-03-14 00:00:00,1,1,30.44,20.61,43.57,40,46,86
2012-03-14 01:00:00,4,4,26.69,40.2,42.74,18,12,30
2012-03-14 02:00:00,3,2,20.93,20.83,33.05,42,121,163
2012-03-14 03:00:00,1,4,26.92,77.19,49.87,34,66,100
2012-03-14 04:00:00,4,2,7.83,57.55,44.66,14,52,66
2012-03-14 05:00:00,4,3,20.86,99.52,7.26,15,52,67
2012-03-14 06:00:00,3,1,13.74,78.69,19.96,34,142,176
2012-03-14 07:00:00,4,1,34.18,61.43,6.6,4,180,184
2012-03-14 08:00:00,3,3,30.71,84.38,23.3,6,120,126
2012-03-14 09:00:00,2,2,27.0,76.38,38.82,20,41,61
2012-03-14 10:00:00,3,4,33.01,39.5,7.79,40,28,68
2012-03-14 11:00:00,2,2,15.41,62.42,44.02,0,46,46
2012-03-14 12:00:00,1,1,32.03,64.48,28.45,24,29,53
2012-03-14 13:00:00,4,3,14.76,56.1,37.45,29,122,151
2012-03-14 14:00:00,3,3,26.98,34.34,2.26,18,13,31
2012-03-14 15:00:00,3,2,27.09,37.87,4.69,23,78,101
2012-03-14 16:00:00,4,2,5.55,42.48,31.04,45,110,155
2012-03-14 17:00:00,4,3,15.83,20.82,41.91,14,58,72
2012-03-14 18:00:00,1,1,5.58,93.36,43.69,34,109,143
2012-03-14 19:00:00,1,4,34.91,74.89,34.42,23,105,128
2012-03-14 20:00:00,3,4,8.67,75.17,10.05,35,63,98
2012-03-14 21:00:00,1,2,21.28,65.79,9.75,48,43,91
2012-03-14 22:00:00,2,3,28.72,75.14,44.07,13,13,26
2012-03-14 23:00:00,1,3,11.04,98.55,5.66,21,152,173
2012-03-15 00:00:00,1,3,19.55,50.81,34.3,38,90,128
2012-03-15 01:00:00,3,1,23.22,77.0,26.68,7,43,50
2012-03-15 02:00:00,2,2,9.81,48.76,21.07,47,60,107
2012-03-15 03:00:00,1,2,28.36,88.34,22.02,15,1,16
2012-03-15 04:00:00,2,2,13.98,88.64,47.26,45,78,123
2012-03-15 05:00:00,2,1,11.33,92.18,43.07,16,73,89
2012-03-15 06:00:00,2,2,21.75,20.44,43.25,4,170,174
2012-03-15 07:00:00,4,4,17.31,43.86,20.33,40,8,48
2012-03-15 08:00:00,4,2,32.61,30.71,5.35,34,188,222
2012-03-15 09:00:00,4,2,31.4,56.32,49.89,36,194,230
2012-03-15 10:00:00,4,2,19.5,59.64,7.27,17,151,168
2012-03-15 11:00:00,3,1,15.78,40.47,25.78,20,192,212
2012-03-15 12:00:00,1,4,14.77,77.88,13.23,41,165,206
2012-03-15 13:00:00,4,4,13.03,41.58,25.54,0,197,197
2012-03-15 14:00:00,3,3,21.34,88.31,15.25,16,132,148
2012-03-15 15:00:00,1,3,29.15,34.21,44.84,7,67,74
2012-03-15 16:00:00,4,4,14.32,49.38,48.42,28,194,222
2012-03-15 17:00:00,1,2,10.7,69.78,20.5,19,157,176
2012-03-15 18:00:00,4,2,19.26,68.43,3.51,48,61,109
2012-03-15 19:00:00,3,2,7.07,26.24,33.17,49,134,183
2012-03-15 20:00:00,2,1,26.04,87.7,18.83,36,178,214
2012-03-15 21:00:00,2,2,20.55,67.85,49.3,38,159,197
2012-03-15 22:00:00,1,1,19.89,89.59,4.47,4,106,110
2012-03-15 23:00:00,3,4,14.01,89.41,5.96,9,73,82
2012-03-16 00:00:00,2,2,32.14,63.67,34.97,5,100,105
2012-03-16 01:00:00,4,2,7.71,92.86,37.93,6,25,31
2012-03-16 02:00:00,2,3,31.09,87.87,23.55,34,42,76
2012-03-16 03:00:00,1,4,16.3,96.65,13.86,26,108,134
2012-03-16 04:00:00,1,2,31.42,88.04,15.49,41,61,102
2012-03-16 05:00:00,3,1,26.86,85.7,16.9,20,158,178
2012-03-16 06:00:00,1,4,8.13,57.55,11.26,23,22,45
2012-03-16 07:00:00,2,3,29.95,36.96,42.53,28,63,91
2012-03-16 08:00:00,2,4,25.47,92.86,3.25,26,71,97
2012-03-16 09:00:00,2,1,5.97,77.8,20.36,37,182,219
2012-03-16 10:00:00,2,3,9.01,42.54,37.38,1,143,144
2012-03-16 11:00:00,3,1,24.07,47.28,0.19,24,119,143
2012-03-16 12:00:00,4,4,24.88,74.89,43.9,1,8,9
2012-03-16 13:00:00,4,3,27.4,58.23,35.31,37,3,40
2012-03-16 14:00:00,3,1,26.61,26.52,3.67,17,38,55
2012-03-16 15:00:00,1,4,24.79,31.32,44.75,41,43,84
2012-03-16 16:00:00,4,1,27.99,79.65,24.37,6,40,46
2012-03-16 17:00:00,1,2,22.25,46.29,32.61,48,12,60
2012-03-16 18:00:00,4,4,12.82,60.61,44.1,3,75,78
2012-03-16 19:00:00,1,3,32.37,81.33,44.06,43,139,182
2012-03-16 20:00:00,3,3,5.55,80.09,20.44,39,23,62
2012-03-16 21:00:00,2,2,16.0,33.36,11.88,40,47,87
2012-03-16 22:00:00,1,1,26.87,27.87,12.87,9,98,107
2012-03-16 23:00:00,2,1,17.81,67.29,38.3,40,31,71
2012-03-17 00:00:00,1,3,5.75,79.33,46.47,27,165,192
2012-03-17 01:00:00,1,1,6.98,31.92,3.61,29,193,222
2012-03-17 02:00:00,1,4,24.46,49.76,0.75,23,181,204
2012-03-17 03:00:00,1,4,33.95,89.62,41.15,35,20,55
2012-03-17 04:00:00,1,3,21.56,95.54,19.33,15,158,173
2012-03-17 05:00:00,2,4,20.2,56.33,13.82,32,63,95
2012-03-17 06:00:00,1,3,14.55,26.36,9.42,9,179,188
2012-03-17 07:00:00,2,1,12.7,40.62,17.32,47,162,209
2012-03-17 08:00:00,3,1,5.63,38.64,48.57,20,143,163
2012-03-17 09:00:00,4,1,13.19,39.12,48.85,26,167,193
2012-03-17 10:00:00,1,2,18.47,59.51,16.58,20,89,109
2012-03-17 11:00:00,4,3,10.94,66.66,48.18,26,37,63
2012-03-17 12:00:00,2,4,7.62,29.8,14.99,31,184,215
2012-03-17 13:00:00,3,1,26.53,91.15,42.72,4,2,6
2012-03-17 14:00:00,3,2,31.84,69.6,10.6,34,164,198
2012-03-17 15:00:00,3,4,33.1,67.78,41.32,21,99,120
2012-03-17 16:00:00,4,4,23.54,98.98,17.69,35,1,36
2012-03-17 17:00:00,2,4,6.58,70.25,9.79,9,2,11
2012-03-17 18:00:00,1,1,27.23,94.32,46.74,33,103,136
2012-03-17 19:00:00,1,4,8.3,42.9,10.71,5,174,179
2012-03-17 20:00:00,2,3,25.09,39.21,49.59,13,105,118
2012-03-17 21:00:00,4,2,28.38,61.32,5.43,36,110,146
2012-03-17 22:00:00,1,4,26.78,60.69,0.5,18,89,107
2012-03-17 23:00:00,2,4,33.56,38.12,43.54,31,26,57
2012-03-18 00:00:00,1,3,27.14,75.97,29.33,19,190,209
2012-03-18 01:00:00,3,4,25.8,22.37,21.08,20,37,57
2012-03-18 02:00:00,1,1,12.85,75.25,4.1,14,171,185
2012-03-18 03:00:00,4,1,32.74,56.57,28.74,16,7,23
2012-03-18 04:00:00,2,1,10.39,75.12,19.69,43,22,65
2012-03-18 05:00:00,4,4,32.15,58.17,24.18,44,133,177
2012-03-18 06:00:00,2,2,14.38,98.19,31.52,23,152,175
2012-03-18 07:00:00,3,2,8.9,46.77,32.0,20,58,78
2012-03-18 08:00:00,2,4,29.8,98.61,48.03,47,184,231
2012-03-18 09:00:00,1,2,5.07,25.2,32.75,14,57,71
2012-03-18 10:00:00,1,2,29.96,74.7,16.97,10,143,153
2012-03-18 11:00:00,3,4,12.87,56.34,16.48,36,25,61
2012-03-18 12:00:00,2,1,31.54,85.77,23.86,29,78,107
2012-03-18 13:00:00,3,4,25.74,83.17,12.97,17,174,191
2012-03-18 14:00:00,1,1,24.99,84.02,18.82,27,95,122
2012-03-18 15:00:00,4,1,15.96,27.58,42.11,12,167,179
2012-03-18 16:00:00,3,2,6.78,85.79,42.99,42,146,188
2012-03-18 17:00:00,4,2,29.9,37.12,31.39,9,116,125
2012-03-18 18:00:00,4,1,10.13,22.05,29.14,46,171,217
2012-03-18 19:00:00,2,1,16.17,37.42,21.35,38,98,136
2012-03-18 20:00:00,3,2,23.01,58.34,31.79,11,153,164
2012-03-18 21:00:00,4,3,19.47,79.37,40.3,49,51,100
2012-03-18 22:00:00,4,1,10.96,37.49,36.89,37,164,201
2012-03-18 23:00:00,2,1,9.22,29.04,1.77,40,76,116
2012-03-19 00:00:00,2,1,8.7,71.68,36.56,47,46,93
2012-03-19 01:00:00,1,2,30.89,98.71,36.0,39,199,238
2012-03-19 02:00:00,4,4,5.95,68.07,4.95,25,13,38
2012-03-19 03:00:00,1,1,34.31,75.28,7.51,43,153,196
2012-03-19 04:00:00,4,1,10.96,64.89,39.4,18,46,64
2012-03-19 05:00:00,1,1,8.31,82.59,27.95,22,93,115
2012-03-19 06:00:00,2,4,22.31,98.06,41.08,47,105,152
2012-03-19 07:00:00,3,4,7.4,63.53,9.24,35,140,175
2012-03-19 08:00:00,2,1,23.07,53.34,1.53,26,138,164
2012-03-19 09:00:00,1,1,30.52,88.83,8.1,15,1,16
2012-03-19 10:00:00,1,3,6.44,97.58,22.63,6,157,163
2012-03-19 11:00:00,3,4,29.0,30.33,26.16,12,114,126
2012-03-19 12:00:00,4,3,16.83,66.25,42.89,11,23,34
2012-03-19 13:00:00,1,1,9.78,83.4,35.81,26,81,107
2012-03-19 14:00:00,1,1,10.28,62.67,49.52,32,22,54
2012-03-19 15:00:00,1,1,32.56,52.74,3.94,30,116,146
2012-03-19 16:00:00,3,1,8.32,72.42,6.51,10,69,79
2012-03-19 17:00:00,2,2,31.0,41.61,4.22,16,109,125
2012-03-19 18:00:00,1,2,21.33,47.93,26.92,37,74,111
2012-03-19 19:00:00,3,2,6.17,99.38,13.34,1,134,135
2012-03-19 20:00:00,1,3,18.93,70.92,34.18,2,174,176
2012-03-19 21:00:00,4,4,29.52,89.83,6.63,33,121,154
2012-03-19 22:00:00,3,1,26.79,84.62,5.16,49,137,186
2012-03-19 23:00:00,1,4,19.66,72.18,23.01,31,84,115
2012-03-20 00:00:00,3,2,30.8,87.26,18.79,23,118,141
2012-03-20 01:00:00,1,1,8.61,42.97,41.46,23,157,180
2012-03-20 02:00:00,2,1,32.3,70.97,41.88,12,175,187
2012-03-20 03:00:00,1,3,30.39,67.25,5.87,21,24,45
2012-03-20 04:00:00,3,4,26.25,69.79,40.62,18,112,130
2012-03-20 05:00:00,4,3,29.54,33.49,28.21,29,23,52
2012-03-20 06:00:00,4,2,21.31,42.18,25.18,38,11,49
2012-03-20 07:00:00,4,4,25.25,42.93,4.74,20,198,218
2012-03-20 08:00:00,1,2,21.82,68.16,36.98,47,161,208
2012-03-20 09:00:00,2,3,15.66,97.8,2.98,22,130,152
2012-03-20 10:00:00,1,3,22.07,96.33,13.88,15,133,148
2012-03-20 11:00:00,4,1,12.72,38.18,4.77,41,58,99
2012-03-20 12:00:00,3,4,18.21,44.39,26.54,6,154,160
2012-03-20 13:00:00,4,4,13.42,22.88,32.26,19,82,101
2012-03-20 14:00:00,3,1,8.69,51.91,44.54,47,71,118
2012-03-20 15:00:00,2,4,14.66,86.77,36.69,41,35,76
2012-03-20 16:00:00,3,2,30.56,93.26,48.06,13,60,73
2012-03-20 17:00:00,1,2,16.43,38.92,38.05,25,99,124
2012-03-20 18:00:00,1,3,27.44,41.26,14.9,21,198,219
2012-03-20 19:00:00,1,2,10.26,37.67,27.38,40,192,232
2012-03-20 20:00:00,3,4,17.73,48.01,22.9,35,132,167
2012-03-20 21:00:00,1,1,8.45,84.38,28.3,25,169,194
2012-03-20 22:00:00,1,3,9.16,71.75,28.6,11,141,152
2012-03-20 23:00:00,1,1,23.52,82.88,35.11,48,64,112
2012-03-21 00:00:00,2,3,23.22,66.64,4.15,30,11,41
2012-03-21 01:00:00,3,3,11.4,40.62,37.34,39,129,168
2012-03-21 02:00:00,3,1,19.23,38.24,7.19,3,13,16
2012-03-21 03:00:00,4,2,30.9,20.72,1.31,39,66,105
2012-03-21 04:00:00,3,2,10.23,82.48,25.95,26,114,140
2012-03-21 05:00:00,2,2,5.58,87.77,29.07,8,98,106
2012-03-21 06:00:00,3,2,24.56,81.46,1.74,11,66,77
2012-03-21 07:00:00,2,1,6.6,25.95,25.77,28,13,41
2012-03-21 08:00:00,2,4,34.4,80.98,26.73,27,161,188
2012-03-21 09:00:00,3,3,23.29,23.66,2.62,15,44,59
2012-03-21 10:00:00,4,1,19.11,28.45,35.58,7,136,143
2012-03-21 11:00:00,1,2,17.9,55.24,10.51,46,137,183
2012-03-21 12:00:00,1,2,22.19,58.09,39.72,48,135,183
2012-03-21 13:00:00,3,1,7.72,85.29,15.54,12,156,168
2012-03-21 14:00:00,3,3,32.9,74.36,23.89,13,60,73
2012-03-21 15:00:00,2,1,23.77,32.27,44.59,14,181,195
2012-03-21 16:00:00,3,1,10.52,38.09,40.31,8,166,174
2012-03-21 17:00:00,2,4,21.88,42.85,39.09,43,32,75
2012-03-21 18:00:00,4,1,9.0,29.89,8.02,31,150,181
2012-03-21 19:00:00,3,4,5.53,43.01,2.41,21,71,92
2012-03-21 20:00:00,1,3,23.92,78.29,30.29,24,126,150
2012-03-21 21:00:00,1,1,24.45,39.31,20.53,40,167,207
2012-03-21 22:00:00,3,1,22.51,86.83,45.45,25,101,126
2012-03-21 23:00:00,2,2,10.5,57.56,17.48,44,22,66
2012-03-22 00:00:00,1,1,23.1,45.83,20.53,28,58,86
2012-03-22 01:00:00,2,2,6.7,52.99,26.3,17,177,194
2012-03-22 02:00:00,3,2,23.28,76.76,39.82,35,99,134
2012-03-22 03:00:00,3,2,21.62,61.34,13.41,19,191,210
2012-03-22 04:00:00,1,3,24.66,20.58,47.09,32,55,87
2012-03-22 05:00:00,3,4,31.86,93.79,27.0,19,170,189
2012-03-22 06:00:00,4,2,30.51,25.28,42.05,2,126,128
2012-03-22 07:00:00,4,1,34.42,95.09,26.28,42,83,125
2012-03-22 08:00:00,1,1,34.29,22.25,38.6,33,57,90
2012-03-22 09:00:00,4,2,28.17,81.68,2.57,5,127,132
2012-03-22 10:00:00,2,2,33.69,62.77,39.96,30,139,169
2012-03-22 11:00:00,1,1,31.02,60.46,26.2,34,163,197
2012-03-22 12:00:00,1,2,26.83,25.82,22.47,31,133,164
2012-03-22 13:00:00,2,4,7.26,39.1,5.58,41,31,72
2012-03-22 14:00:00,4,4,6.47,82.2,37.08,8,192,200
2012-03-22 15:00:00,4,3,30.13,91.3,6.56,45,187,232
2012-03-22 16:00:00,4,2,19.69,62.33,9.62,47,181,228
2012-03-22 17:00:00,1,3,29.44,48.27,6.32,26,151,177
2012-03-22 18:00:00,1,3,14.39,24.8,0.33,23,156,179
2012-03-22 19:00:00,4,3,16.93,74.57,33.1,49,7,56
2012-03-22 20:00:00,3,2,26.01,42.28,13.54,21,12,33
2012-03-22 21:00:00,4,3,32.46,24.4,7.47,29,62,91
2012-03-22 22:00:00,2,4,7.63,73.27,16.0,35,24,59
2012-03-22 23:00:00,1,3,30.84,58.86,24.95,25,156,181
2012-03-23 00:00:00,2,4,28.79,20.96,25.17,49,186,235
2012-03-23 01:00:00,2,4,14.47,28.87,18.36,1,60,61
2012-03-23 02:00:00,1,2,15.66,75.94,24.75,41,87,128
2012-03-23 03:00:00,3,3,6.39,25.09,21.37,43,124,167
2012-03-23 04:00:00,4,2,5.47,89.28,41.13,6,25,31
2012-03-23 05:00:00,2,4,19.31,44.91,1.48,26,83,109
2012-03-23 06:00:00,1,1,7.87,27.09,43.4,15,195,210
2012-03-23 07:00:00,2,3,10.82,80.78,12.2,48,21,69
2012-03-23 08:00:00,4,2,30.4,61.95,36.09,45,134,179
2012-03-23 09:00:00,3,1,22.13,44.53,20.25,28,184,212
2012-03-23 10:00:00,3,3,24.01,52.49,14.72,20,61,81
2012-03-23 11:00:00,3,3,10.62,21.71,30.77,25,121,146
2012-03-23 12:00:00,1,2,29.86,73.02,38.44,17,117,134
2012-03-23 13:00:00,1,1,31.04,49.26,22.5,0,145,145
2012-03-23 14:00:00,3,2,20.7,77.12,23.33,1,9,10
2012-03-23 15:00:00,4,3,32.38,70.25,2.94,13,30,43
2012-03-23 16:00:00,4,3,30.34,72.1,46.2,37,25,62
2012-03-23 17:00:00,1,4,26.94,83.43,42.34,14,182,196
2012-03-23 18:00:00,3,3,27.02,70.49,19.9,35,108,143
2012-03-23 19:00:00,4,3,8.16,53.5,38.25,23,89,112
2012-03-23 20:00:00,4,1,13.13,51.19,15.66,24,125,149
2012-03-23 21:00:00,4,1,7.01,29.57,36.52,8,24,32
2012-03-23 22:00:00,1,4,5.26,82.36,25.83,14,119,133
2012-03-23 23:00:00,3,4,9.75,80.89,23.04,36,179,215
2012-03-24 00:00:00,2,4,31.41,39.7,2.83,5,17,22
2012-03-24 01:00:00,3,2,12.2,89.01,48.27,42,151,193
2012-03-24 02:00:00,3,2,34.1,67.12,41.87,44,107,151
2012-03-24 03:00:00,1,4,22.92,58.29,39.67,11,142,153
2012-03-24 04:00:00,4,2,12.12,21.4,15.25,26,127,153
2012-03-24 05:00:00,4,3,19.91,50.62,14.48,6,7,13
2012-03-24 06:00:00,1,4,11.57,71.25,28.66,27,42,69
2012-03-24 07:00:00,1,4,34.52,27.18,42.31,11,23,34
2012-03-24 08:00:00,1,2,30.42,56.77,46.73,41,116,157
2012-03-24 09:00:00,1,1,5.79,99.47,13.45,34,101,135
2012-03-24 10:00:00,1,4,33.43,77.32,30.37,1,64,65
2012-03-24 11:00:00,2,2,26.63,63.75,36.2,25,25,50
2012-03-24 12:00:00,3,2,7.47,62.64,11.32,19,73,92
2012-03-24 13:00:00,3,1,25.12,23.5,20.37,24,153,177
2012-03-24 14:00:00,3,4,24.41,96.59,9.37,20,65,85
2012-03-24 15:00:00,4,1,11.56,94.25,34.95,0,167,167
2012-03-24 16:00:00,2,3,27.75,74.59,43.19,27,13,40
2012-03-24 17:00:00,3,1,7.61,27.92,43.88,37,160,197
2012-03-24 18:00:00,4,1,19.68,36.63,33.5,12,184,196
2012-03-24 19:00:00,2,2,5.3,34.71,17.36,29,166,195
2012-03-24 20:00:00,2,1,34.06,61.57,33.05,9,128,137
2012-03-24 21:00:00,4,3,27.55,36.62,43.21,44,93,137
2012-03-24 22:00:00,2,2,9.77,75.66,31.29,21,36,57
2012-03-24 23:00:00,4,3,15.25,63.62,20.64,28,17,45
2012-03-25 00:00:00,3,1,9.82,21.41,45.99,4,157,161
2012-03-25 01:00:00,4,3,28.0,79.52,41.76,7,154,161
2012-03-25 02:00:00,2,3,6.77,35.11,44.12,10,187,197
2012-03-25 03:00:00,3,1,30.21,85.99,45.16,25,176,201
2012-03-25 04:00:00,3,1,33.27,48.4,19.69,18,112,130
2012-03-25 05:00:00,1,2,25.3,47.09,42.98,18,29,47
2012-03-25 06:00:00,1,2,11.39,20.95,28.52,29,172,201
2012-03-25 07:00:00,2,4,15.8,99.02,1.91,35,99,134
2012-03-25 08:00:00,4,2,19.32,68.96,31.79,41,20,61
2012-03-25 09:00:00,4,1,23.14,53.82,23.53,8,181,189
2012-03-25 10:00:00,2,3,25.06,27.73,13.76,6,143,149
2012-03-25 11:00:00,3,3,21.63,75.93,48.52,17,17,34
2012-03-25 12:00:00,2,2,15.54,42.62,2.75,8,161,169
2012-03-25 13:00:00,2,2,31.73,99.06,47.29,5,148,153
2012-03-25 14:00:00,3,1,7.44,96.04,7.96,5,158,163
2012-03-25 15:00:00,4,3,18.99,78.82,18.85,44,9,53
2012-03-25 16:00:00,2,4,28.27,97.69,20.86,21,104,125
2012-03-25 17:00:00,4,4,6.83,28.45,36.55,16,3,19
2012-03-25 18:00:00,2,2,26.16,42.39,10.78,14,14,28
2012-03-25 19:00:00,3,4,29.59,40.26,49.31,8,52,60
2012-03-25 20:00:00,3,1,24.82,25.76,37.45,5,186,191
2012-03-25 21:00:00,1,4,5.39,97.78,39.5,22,54,76
2012-03-25 22:00:00,3,2,10.4,24.8,5.32,16,189,205
2012-03-25 23:00:00,1,1,15.26,88.54,23.82,31,169,200
2012-03-26 00:00:00,2,3,12.01,81.45,47.28,31,155,186
2012-03-26 01:00:00,4,1,33.88,50.07,13.5,36,121,157
2012-03-26 02:00:00,3,2,24.55,21.5,7.27,2,134,136
2012-03-26 03:00:00,3,2,13.91,20.49,24.27,15,138,153
2012-03-26 04:00:00,3,4,32.89,36.32,46.52,1,156,157
2012-03-26 05:00:00,2,4,27.22,59.51,24.34,2,161,163
2012-03-26 06:00:00,1,3,13.54,56.63,20.24,40,115,155
2012-03-26 07:00:00,2,3,16.37,66.82,32.51,13,124,137
2012-03-26 08:00:00,4,2,10.98,81.76,46.84,13,115,128
2012-03-26 09:00:00,2,2,34.13,50.19,2.45,29,93,122
2012-03-26 10:00:00,4,2,20.52,32.83,7.67,48,24,72
2012-03-26 11:00:00,3,3,31.88,84.0,6.64,39,183,222
2012-03-26 12:00:00,4,2,15.39,46.62,4.27,48,101,149
2012-03-26 13:00:00,4,3,30.83,42.95,15.11,26,39,65
2012-03-26 14:00:00,1,2,6.62,81.14,11.47,16,119,135
2012-03-26 15:00:00,4,1,34.46,94.73,27.43,38,92,130
2012-03-26 16:00:00,4,1,32.36,93.2,16.36,8,190,198
2012-03-26 17:00:00,2,2,15.9,31.0,20.26,35,118,153
2012-03-26 18:00:00,3,1,28.24,60.25,47.09,9,177,186
2012-03-26 19:00:00,2,3,27.57,27.43,7.78,28,10,38
2012-03-26 20:00:00,2,4,32.04,96.88,19.42,3,187,190
2012-03-26 21:00:00,3,1,14.22,37.22,12.85,20,191,211
2012-03-26 22:00:00,3,4,18.97,35.79,27.46,36,131,167
2012-03-26 23:00:00,4,1,30.95,91.11,36.82,1,158,159
2012-03-27 00:00:00,4,3,28.36,97.43,40.85,14,73,87
2012-03-27 01:00:00,1,1,16.8,75.81,25.76,27,53,80
2012-03-27 02:00:00,2,1,30.37,29.68,42.75,24,79,103
2012-03-27 03:00:00,3,2,6.41,58.87,39.25,25,55,80
2012-03-27 04:00:00,4,4,28.46,85.33,7.85,8,116,124
2012-03-27 05:00:00,3,4,11.2,65.8,12.27,29,93,122
2012-03-27 06:00:00,4,3,13.58,30.61,33.59,8,98,106
2012-03-27 07:00:00,1,3,19.8,33.75,48.74,0,43,43
2012-03-27 08:00:00,1,4,18.49,89.13,18.81,11,4,15
2012-03-27 09:00:00,3,2,20.62,62.16,11.49,44,194,238
2012-03-27 10:00:00,1,2,21.34,76.47,43.46,12,79,91
2012-03-27 11:00:00,3,4,14.95,49.85,9.98,13,67,80
2012-03-27 12:00:00,4,1,10.26,62.6,34.87,9,136,145
2012-03-27 13:00:00,2,4,28.05,98.17,1.71,16,3,19
2012-03-27 14:00:00,1,1,17.0,46.38,0.95,16,84,100
2012-03-27 15:00:00,4,4,20.18,73.98,22.58,30,116,146
2012-03-27 16:00:00,2,1,24.34,33.8,32.83,45,94,139
2012-03-27 17:00:00,2,2,32.29,29.74,7.12,48,15,63
2012-03-27 18:00:00,2,4,26.23,82.69,38.19,25,110,135
2012-03-27 19:00:00,4,3,6.36,87.53,6.44,34,69,103
2012-03-27 20:00:00,4,1,30.16,73.46,26.69,35,14,49
2012-03-27 21:00:00,3,2,34.68,32.66,15.41,10,106,116
2012-03-27 22:00:00,2,3,19.17,39.25,37.61,15,179,194
2012-03-27 23:00:00,2,2,34.09,92.89,40.21,28,158,186
2012-03-28 00:00:00,2,1,21.42,43.1,3.3,44,93,137
2012-03-28 01:00:00,3,4,18.79,85.51,9.63,17,79,96
2012-03-28 02:00:00,2,2,14.94,42.87,44.63,10,43,53
2012-03-28 03:00:00,4,4,24.73,95.16,20.78,10,163,173
2012-03-28 04:00:00,2,4,11.89,93.16,23.84,8,125,133
2012-03-28 05:00:00,1,2,8.15,23.46,8.4,24,129,153
2012-03-28 06:00:00,4,2,5.82,81.63,49.74,31,155,186
2012-03-28 07:00:00,3,2,13.77,33.56,46.15,33,111,144
2012-03-28 08:00:00,2,4,16.87,37.22,0.1,2,39,41
2012-03-28 09:00:00,1,3,21.56,56.79,27.54,13,62,75
2012-03-28 10:00:00,3,1,13.78,66.11,43.61,47,62,109
2012-03-28 11:00:00,3,3,34.52,46.06,21.53,39,16,55
2012-03-28 12:00:00,4,4,13.75,66.03,21.84,24,37,61
2012-03-28 13:00:00,3,2,18.23,33.65,18.97,15,127,142
2012-03-28 14:00:00,3,2,8.1,21.79,1.44,35,163,198
2012-03-28 15:00:00,3,1,12.82,65.7,39.51,8,159,167
2012-03-28 16:00:00,3,1,6.45,61.39,22.84,3,181,184
2012-03-28 17:00:00,2,3,21.79,75.17,26.55,44,186,230
2012-03-28 18:00:00,2,3,27.53,71.99,12.78,1,24,25
2012-03-28 19:00:00,2,1,10.87,91.8,39.21,24,76,100
2012-03-28 20:00:00,2,4,16.04,56.76,39.69,49,141,190
2012-03-28 21:00:00,1,3,5.5,20.67,27.65,21,171,192
2012-03-28 22:00:00,2,2,30.19,70.45,45.23,4,123,127
2012-03-28 23:00:00,3,2,28.4,74.01,5.79,48,24,72
2012-03-29 00:00:00,2,4,6.9,61.72,39.33,20,34,54
2012-03-29 01:00:00,2,1,15.95,75.14,27.93,9,78,87
2012-03-29 02:00:00,4,3,33.66,45.89,11.55,22,174,196
2012-03-29 03:00:00,3,2,16.76,31.9,6.62,26,174,200
2012-03-29 04:00:00,2,1,20.79,73.16,15.05,29,144,173
2012-03-29 05:00:00,2,3,15.66,39.61,42.82,3,88,91
2012-03-29 06:00:00,2,4,22.88,56.51,39.38,5,22,27
2012-03-29 07:00:00,1,2,34.34,59.33,32.26,25,121,146
2012-03-29 08:00:00,2,4,34.93,58.18,4.52,9,16,25
2012-03-29 09:00:00,4,4,28.24,67.88,47.74,48,28,76
2012-03-29 10:00:00,3,4,17.13,22.36,15.27,4,1,5
2012-03-29 11:00:00,3,3,19.83,99.17,30.35,38,10,48
2012-03-29 12:00:00,2,4,15.7,77.3,40.16,36,15,51
2012-03-29 13:00:00,2,3,34.57,54.03,6.64,39,178,217
